Abychom	a b I x o m
Ahoi	a h\ o I
Ahoj	a h\ o j
Aktualně	a k t u a l J e
Americké	a m e r I t_s k e:
Američane	a m e r I t_S a n e
Así	a s i:
Australie	a_u s t r a l I e
Auto	a_u t o
Azií	a z I i:
Baltske	b a l t s k e
Behem	b e h\ e m
Berlíne	b e r l i: n e
Bilé	b I l e:
Bobik	b o b I k
BrylE	b r I l e
Bude	b u d e
Budejovici	b u d e j o v I t_s I
Budemé	b u d e m e:
Budes	b u d e s
Bukareštu	b u k a r e S t u
Bůde	b u: d e
Cely	t_s e l I
Chces	x t_s e s
Chcí	x t_s i:
Checam	x e t_s a m
Chechach	x e x a x
Chodim	x o J\ I m
Chodíl	x o J\ i: l
Chtela	x t e l a
Chtelá	x t e l a:
Chtěla	x c e l a
Cizi	t_s I z I
Cítíli	t_s i: c i: l I
Dava	d a v a
Davej	d a v e j
Davá	d a v a:
Dekuji	d e k u j I
Dekuju	d e k u j u
Diky	J\ I k I
Diplomku	J\ I p l o m k u
Ditě	J\ I c e
Dneská	d n e s k a:
Dobry	d o b r I
Dobá	d o b a:
Dom	d o m
Domnivali	d o m J I v a l I
Domu	d o m u
Dospěli	d o s p j e l I
Dostaváme	d o s t a v a: m e
Doufam	d o_u f a m
Draždanech	d r a Z d a n e x
Dražďan	d r a Z J\ a n
Dražďanech	d r a Z J\ a n e x
Dražďany	d r a Z J\ a n I
Druha	d r u h\ a
Drášďan	d r a: S J\ a n
Drášďanech	d r a: S J\ a n e x
Duležitějsí	d u l e Z I c e j s i:
Dál	d a: l
Dějíny	J\ e j i: n I
Děkuji	J\ e k u j I
Děkuju	J\ e k u j u
Dětí	J\ e c i:
Dřive	d P\ I v e
Důležite	d u: l e Z I t e
E-mail	e m a I l
Egiptu	e g I p t u
Email	e m a I l
Filozofii	f I l o z o f I I
Hlasili	h\ l a s I l I
Hledam	h\ l e d a m
Hlávnim	h\ l a: v J I m
Hodi	h\ o J\ I
Honzika	h\ o n z I k a
Hotelu	h\ o t e l u
Hrád	h\ r a: t
Icestovani	I t_s e s t o v a J I
Ikdyž	I g d I S
Inaměsti	I n a m J e s c I
Indianove	I n J\ I a n o v e
Ing	I N g
Internetu	I n t e r n e t u
Italie	I t a l I e
Italii	I t a l I I
Italíe	I t a l i: e
Italíi	I t a l i: I
Ja	j a
Jake	j a k e
Jeji	j e j I
Jesti	j e s c I
Ješte	j e S t e
Jsem	j s e m
Já	j a:
Jáka	j a: k a
Jínak	j i: n a k
Jště	j S c e
Katy	k a t I
Kazde	k a z d e
Kazdy	k a z d I
Kazdý	k a z d i:
Každa	k a Z d a
Každe	k a Z d e
Každy	k a Z d I
Kdiz	g d I s
Kdy	g d I
Kdé	g d e:
Kdýž	g d i: S
Knihovne	k J I h\ o v n e
Knihovně	k J I h\ o v J e
Kolik	k o l I k
Kolikrat	k o l I k r a t
Kolík	k o l i: k
Konečny	k o n e t_S n I
Kouka	k o_u k a
Koupáji	k o_u p a: j I
Košiče	k o S I t_S e
Ktery	k t e r I
Kterí	k t e r i:
Kurz	k u r s
Kurzy	k u r z I
Křivoklat	k Q\ I v o k l a t
Libilo	l I b I l o
Libí	l I b i:
Lide	l I d e
Londynu	l o n d I n u
Lídé	l i: d e:
Ma	m a
Maji	m a j I
Malte	m a l t e
Mam	m a m
Mame	m a m e
Mate	m a t e
Maš	m a S
Mej	m e j
Mejse	m e j s e
Mejte	m e j t e
Melo	m e l o
Mila	m I l a
Mily	m I l I
Minúla	m I n u: l a
Mnohy	m= n o h\ I
Mochla	m o x l a
Mochli	m o x l I
Mohou	m o h\ o_u
Momentalně	m o m e n t a l J e
Morave	m o r a v e
Mozná	m o z n a:
Mozně	m o z J e
Možna	m o Z n a
MudR	m u d r=
Muj	m u j
Musim	m u s I m
Musiš	m u s I S
Muslím	m u s l i: m
Musílá	m u s i: l a:
Muz	m u s
Muzu	m u z u
Mušež	m u S e S
Muže	m u Z e
Mužeme	m u Z e m e
Mužete	m u Z e t e
Mužeš	m u Z e S
Mužou	m u Z o_u
Mužu	m u Z u
Mysim	m I s I m
Myslim	m I s l I m
Myslíla	m I s l i: l a
Myslým	m I s l i: m
Mála	m a: l a
Mátka	m a: t k a
MíláEvo	m i: l a: e v o
Mímo	m i: m o
Míslím	m i: s l i: m
Mýslím	m i: s l i: m
Můzeme	m u: z e m e
Můzete	m u: z e t e
Můž	m u: S
Může	m u: Z e
Napsála	n a p s a: l a
Napíš	n a p i: S
Napřiklad	n a p Q\ I k l a t
Napříkla	n a p Q\ i: k l a
Nas	n a s
Nasledujicim	n a s l e d u j I t_s I m
Naučíl	n a_u t_S i: l
Naš	n a S
Ne	n e
Nedavno	n e d a v n o
Nejaké	n e j a k e:
Nejdřive	n e j d P\ I v e
Nekolik	n e k o l I k
Nemam	n e m a m
Nemecku	n e m e t_s k u
Neplanuju	n e p l a n u j u
Neráda	n e r a: d a
Nevim	n e v I m
Neviš	n e v I S
Nevím	n e v i: m
Neznámena	n e z n a: m e n a
Nádraží	n a: d r a Z i:
Náše	n a: S e
Náštěstí	n a: S c e s c i:
Někteři	J e k t e P\ I
Němečko	J e m e t_S k o
Obdobi	o b d o b I
Obratím	o b r a c i: m
Obyčejne	o b I t_S e j n e
Odpolodne	o d p o l o d n e
Odpovída	o d p o v i: d a
Oní	o J i:
Osmnácteho	o s m= n a: t_s t e h\ o
Ostatni	o s t a t J I
Otěc	o c e t_s
PIN-kod	p I n k o t
PRI	p r I
Pana	p a n a
Pani	p a J I
Phd	p h\ t
Pilzeňský	p I l z e J s k i:
Pisu	p I s u
Pišu	p I S u
Planue	p l a n u e
Platim	p l a c I m
Plávali	p l a: v a l I
Podlě	p o d l j e
Pojedu	p o j e d u
Polsku.Rádá	p o l s k u r a: d a:
Ponevadz	p o n e v a d s
Ponevadž	p o n e v a d S
Posilam	p o s I l a m
Posilaš	p o s I l a S
Posilám	p o s I l a: m
Posledny	p o s l e d n I
Poslete	p o s l e t e
Potkál	p o t k a: l
Potvržením	p o t v r= Z e J i: m
Pozdravem	p o z d r a v e m
Poznátky	p o z n a: t k I
Poznávam	p o z n a: v a m
Počasi	p o t_S a s I
Pořad	p o P\ a t
Pořát	p o P\ a: t
Prace	p r a t_s e
Prahi	p r a h\ I
Pravocat	p r a v o t_s a t
Pravě	p r a v j e
Pražáné	p r a Z a: n e:
Pred	p r e t
Preju	p r e j u
Prestože	p r e s t o Z e
Prijedlí	p r I j e d l i:
Prijela	p r I j e l a
Prosim	p r o s I m
Proto	p r o t o
Protoze	p r o t o z e
Prvni	p r= v J I
Próto	p r o: t o
Ptaš	p t a S
Pátek	p a: t e k
Píjéme	p i: j e: m e
Pírne	p i: r n e
Předevšim	p Q\ e d e v S I m
Předpokladám	p Q\ e d p o k l a d a: m
Přesne	p Q\ e s n e
Přišti	p Q\ I S c I
Příjela	p Q\ i: j e l a
Rad	r a t
Rada	r a d a
Radi	r a J\ I
Radá	r a d a:
Republice	r e p u b l I t_s e
Rodina	r o J\ I n a
Romanyy	r o m a n I I
Rádá	r a: d a:
Ríká	r i: k a:
Samozřejme	s a m o z P\ e j m e
Samozřejmně	s a m o z P\ e j m J e
Samozřejmy	s a m o z P\ e j m I
Samozřejmňe	s a m o z P\ e j m J e
Samozřemě	s a m o z P\ e m J e
Samožrejme	s a m o Z r e j m e
Samožrejmě	s a m o Z r e j m J e
Sedjeme	s e d j e m e
Setkame	s e t k a m e
Setkavame	s e t k a v a m e
Setkáva	s e t k a: v a
Sidí	s I J\ i:
Skola	s k o l a
Slovinski	s l o v I n s k I
Snažít	s n a Z i: t
Solný	s o l n i:
Souhlasiš	s o_u h\ l a s I S
Souhlsiš	s o_u h\ l= s I S
Součastný	s o_u t_S a s t n i:
Spanělsku	s p a J e l s k u
Specialní	s p e t_s I a l J i:
Srdečne	s r= d e t_S n e
Srp	s r= p
Stoveti	s t o v e c I
Státy	s t a: t I
Svazem	s v a z e m
Svícarsko	s v i: t_s a r s k o
Syrii	s I r I I
Take	t a k e
Takím	t a k i: m
Taký	t a k i:
Tatinek	t a c I n e k
Tatinka	t a c I N k a
Tebé	t e b e:
Tebě	t e b j e
Tehdější	t e h\ J\ e j S i:
Ten	t e n
Tenta	t e n t a
Teple	t e p l e
Tesi	t e s I
Tetno	t e t n o
Tešela	t e S e l a
Teši	t e S I
Tešim	t e S I m
Teším	t e S i: m
Thaiska	t h\ a I s k a
Ti	c I
Tomaš	t o m a S
Totiz	t o c I s
Treba	t r e b a
Trikrát	t r I k r a: t
Trplivost	t r= p l I v o s t
Tva	t v a
Tve	t v e
Tvrzeni	t v r= z e J I
Tvuj	t v u j
Tvuji	t v u j I
Ty	t I
Tám	t a: m
Tí	c i:
Těsim	c e s I m
Těsím	c e s i: m
Těšim	c e S I m
Těší	c e S i:
Těším	c e S i: m
Umení	u m e J i:
Umožnuje	u m o Z n u j e
Univerzitě	u J I v e r z I c e
Uspešně	u s p e S J e
Uvidime	u v I J\ I m e
Učime	u t_S I m e
Uždítě	u Z J\ i: c e
Vam	v a m
Važený	v a Z e n i:
Vic	v I t_s
Vidime	v I J\ I m e
Vim	v I m
Vino	v I n o
Vite	v I t e
Vitám	v I t a: m
Viš	v I S
Vspomínám	v s p o m i: n a: m
Vydělavat	v I J\ e l a v a t
Vyhody	v I h\ o d I
Vypravovalajsi	v I p r a v o v a l a j s I
Vyrustala	v I r u s t a l a
Vyučovácí	v I u t_S o v a: t_s i:
Vzdelaný	v z d e l a n i:
Vzdy	v z d I
Vzdycky	v z d I t_s k I
Vám	v a: m
Vámi	v a: m I
Vás	v a: s
Víc	v i: t_s
Vídím	v i: J\ i: m
Vý	v i:
Výsokou	v i: s o k o_u
Většína	v j e t S i: n a
Všechný	v S e x n i:
Všehno	v S e h\ n o
Všichní	v S I x J i:
Všíchni	v S i: x J I
Vždycký	v Z d I t_s k i:
Zachrána	z a x r a: n a
Zajimalo	z a j I m a l o
Zaleží	z a l e Z i:
Zamozřejmě	z a m o z P\ e j m J e
Zapamátovála	z a p a m a: t o v a: l a
Zaroveň	z a r o v e J
Zatim	z a c I m
Začinal	z a t_S I n a l
Začinám	z a t_S I n a: m
Země	z e m J e
Zena	z e n a
Zeptame	z e p t a m e
Zitra	z I t r a
Znad	z n a t
Znalostí	z n a l o s c i:
Znam	z n a m
Znamena	z n a m e n a
Znamý	z n a m i:
Znaš	z n a S
Ználost	z n a: l o s t
Známena	z n a: m e n a
Zustala	z u s t a l a
Zítrá	z i: t r a:
a	a
absolvovát	a b s o l v o v a: t
abyh	a b I x
abyse	a b I s e
adekvatně	a d e k v a t J e
adressa	a d r e s a
aktualní	a k t u a l J i:
aktéřy	a k t e: P\ I
apod	a p o t
at	a t
atd	a t t
atmosferá	a t m o s f e r a:
atmosfeře	a t m o s f e P\ e
atď	a t c
aute	a_u t e
b	p
baraku	b a r a k u
barú	b a r u:
bavim	b a v I m
baťochu	b a c o x u
behem	b e h\ e m
belo	b e l o
beloruštíně	b e l o r u S c i: J e
bezpecní	b e z p e t_s J i:
bežný	b e Z n i:
bežoucím	b e Z o_u t_s i: m
bidlý	b I d l i:
bilo	b I l o
bily	b I l I
blizko	b l I z k o
bliš	b l I S
bluzu	b l u z u
bohaty	b o h\ a t I
botičký	b o c I t_S k i:
brigadech	b r I g a d e x
brigadě	b r I g a J\ e
brile	b r I l e
brily	b r I l I
bryle	b r I l e
brzou	b r= z o_u
bríle	b r i: l e
brěznu	b r j e z n u
buch	b u x
bude	b u d e
budes	b u d e s
budlím	b u d l i: m
budoucností	b u d o_u t_s n o s c i:
budoucní	b u d o_u t_s J i:
budousna	b u d o_u s n a
budé	b u d e:
buodu	b u o d u
buzy	b u z I
by	b I
bych	b I x
bydlenim	b I d l e J I m
bydli	b I d l I
bydlim	b I d l I m
bydlite	b I d l I t e
bydliš	b I d l I S
bydly	b I d l I
byh	b I x
byla	b I l a
bylí	b I l i:
byt	b I t
byvalo	b I v a l o
byznesman	b I z n e s m a n
byš	b I S
bých	b i: x
býchom	b i: x o m
býlo	b i: l o
býtu	b i: t u
běhěm	b j e h\ j e m
břeholníky	b P\ e h\ o l J i: k I
břežna	b P\ e Z n a
bůdu	b u: d u
c	t_s
ca	t_s a
cas	t_s a s
casto	t_s a s t o
caš	t_s a S
ce	t_s e
cela	t_s e l a
celem	t_s e l e m
celkove	t_s e l k o v e
cely	t_s e l I
cenadénně	t_s e n a d e: n j e
certifikaty	t_s e r c I f I k a t I
cervence	t_s e r v e n t_s e
ceskeho	t_s e s k e h\ o
ceský	t_s e s k i:
cestach	t_s e s t a x
cestovalá	t_s e s t o v a l a:
cestovaní	t_s e s t o v a J i:
cestá	t_s e s t a:
chceté	x t_s e t e:
chceš.Ješte	x t_s e S j e S t e
chcéme	x t_s e: m e
chcí	x t_s i:
cheme	x e m e
chitra	x I t r a
chitrych	x I t r I x
chodi	x o J\ I
chodime	x o J\ I m e
chodít	x o J\ i: t
cholka	x o l k a
chovaní	x o v a J i:
chovaný	x o v a n i:
chovát	x o v a: t
chripku	x r I p k u
chte	x t e
chteji	x t e j I
chtejí	x t e j i:
chtel	x t e l
chtela	x t e l a
chteli	x t e l I
chtely	x t e l I
chtit	x c I t
chtěji	x c e j I
chtělá	x c e l a:
chutně	x u t J e
chutu	x u t u
chvili	x v I l I
chvilě	x v I l j e
chvílí	x v i: l i:
chýtrý	x i: t r i:
cist	t_s I s t
citi	t_s I c I
citila	t_s I c I l a
citim	t_s I c I m
citime	t_s I c I m e
citit	t_s I c I t
cití	t_s I c i:
citím	t_s I c i: m
cizíně	t_s I z i: J e
clověk	t_s l o v j e k
clověka	t_s l o v j e k a
clubě	t_s l u b j e
coje	t_s o j e
conversace	t_s o n v e r s a t_s e
cvíčit	t_s v i: t_S I t
célý	t_s e: l i:
cí	t_s i:
císt	t_s i: s t
cít	t_s i: t
cítatů	t_s i: t a t u:
cíti	t_s i: c I
cítime	t_s i: c I m e
cízimzé	t_s i: z I m z e:
cízinec	t_s i: z I n e t_s
cízině	t_s i: z I J e
cízí	t_s i: z i:
cízím	t_s i: z i: m
dal	d a l
dale	d a l e
dalsí	d a l s i:
dalé	d a l e:
dalí	d a l i:
dalšmíhostmí	d a l S m i: h\ o s t m i:
dana	d a n a
darek	d a r e k
darmo	d a r m o
dat	d a t
dava	d a v a
davala	d a v a l a
davam	d a v a m
davat	d a v a t
davno	d a v n o
davá	d a v a:
daváme	d a v a: m e
davát	d a v a: t
dekuji	d e k u j I
dekuju	d e k u j u
dekují	d e k u j i:
delal	d e l a l
delala	d e l a l a
delame	d e l a m e
delat	d e l a t
delá	d e l a:
delála	d e l a: l a
deláme	d e l a: m e
demonštrovat	d e m o n S t r o v a t
demonštruje	d e m o n S t r u j e
desatého	d e s a t e: h\ o
desetí	d e s e c i:
detajly	d e t a j l I
deti	d e c I
detství	d e t s t v i:
deśet	d e e t
diky	J\ I k I
diplomonovou	J\ I p l o m o n o v o_u
ditě	J\ I c e
ditěte	J\ I c e t e
ditětem	J\ I c e t e m
ditěti	J\ I c e c I
divaji	J\ I v a j I
divají	J\ I v a j i:
divam	J\ I v a m
divat	J\ I v a t
divám	J\ I v a: m
diťete	J\ I c e t e
dlohý	d l o h\ i:
dlouhe	d l o_u h\ e
dlóuho	d l o: u h\ o
dlůh	d l u: x
dnesek	d n e s e k
dnešni	d n e S J I
dnešnim	d n e S J I m
dní	d J i:
dněšek	d J e S e k
dněšního	d J e S J i: h\ o
do	d o
dobra	d o b r a
dobre	d o b r e
dobreho	d o b r e h\ o
dobri	d o b r I
dobry	d o b r I
dobrímslovem	d o b r i: m s l o v e m
dobé	d o b e:
dobŘé	d o b e:
dobře	d o b P\ e
dobřé	d o b P\ e:
dobše	d o b S e
dobže	d o b Z e
dochazejí	d o x a z e j i:
dochazet	d o x a z e t
dochazí	d o x a z i:
dodatkovy	d o d a t k o v I
dohromadí	d o h\ r o m a J\ i:
dojit	d o j I t
dokazalí	d o k a z a l i:
dokaže	d o k a Z e
dokažu	d o k a Z u
doktorantskou	d o k t o r a n t s k o_u
domu	d o m u
donno-denně	d o n o d e n j e
doplnujicí	d o p l= n u j I t_s i:
doplomovou	d o p l o m o v o_u
dosahl	d o s a h\ l=
dosahli	d o s a h\ l I
dosahneme	d o s a h\ n e m e
dosahnout	d o s a h\ n o_u t
doslová	d o s l o v a:
dospelí	d o s p e l i:
dostalí	d o s t a l i:
dostané	d o s t a n e:
dostanéme	d o s t a n e: m e
dostavali	d o s t a v a l I
dostavame	d o s t a v a m e
dostavaní	d o s t a v a J i:
dostavat	d o s t a v a t
dostavá	d o s t a v a:
dostaváme	d o s t a v a: m e
dostupnosti	d o s t u p n o s c I
dostáli	d o s t a: l I
douhe	d o_u h\ e
douležita	d o_u l e Z I t a
dovolena	d o v o l e n a
dovolene	d o v o l e n e
dovolenu	d o v o l e n u
dovonenou	d o v o n e n o_u
dovědností	d o v j e d n o s c i:
dozvednosti	d o z v e d n o s c I
dozvedností	d o z v e d n o s c i:
drahu	d r a h\ u
dražsí	d r a Z s i:
druha	d r u h\ a
druhí	d r u h\ i:
duležita	d u l e Z I t a
duležite	d u l e Z I t e
duležitou	d u l e Z I t o_u
duležité	d u l e Z I t e:
duma	d u m a
duševne	d u S e v n e
dvadcátím	d v a d t_s a: c i: m
dvakrat	d v a k r a t
dve	d v e
dvelůzkovy	d v e l u: z k o v I
dvoulužkovy	d v o_u l u Z k o v I
dvoulůzkový	d v o_u l u: z k o v i:
dvouměsiční	d v o_u m J e s I t_S J i:
dvá	d v a:
dvé	d v e:
dvěřích	d v j e P\ i: x
dyplomu	d I p l o m u
dáRék	d a: r e: k
dál	d a: l
dálo	d a: l o
dáva	d a: v a
dávnemu	d a: v n e m u
dávát	d a: v a: t
délší	d e: l S i:
dén	d e: n
díte	J\ i: t e
dítětí	J\ i: c e c i:
dívame	J\ i: v a m e
dívila	J\ i: v I l a
dědíctví	J\ e J\ i: t_s t v i:
děla	J\ e l a
dělaji	J\ e l a j I
dělame	J\ e l a m e
dělime	J\ e l I m e
dělát	J\ e l a: t
dětmí	J\ e t m i:
dětstvi	J\ e t s t v I
dětí	J\ e c i:
dětčtví	J\ e t t_S t v i:
dřiv	d P\ I f
důlezité	d u: l e z I t e:
důležita	d u: l e Z I t a
důležite	d u: l e Z I t e
důležity	d u: l e Z I t I
důležíte	d u: l e Z i: t e
důležítost	d u: l e Z i: t o s t
důležítou	d u: l e Z i: t o_u
důležíté	d u: l e Z i: t e:
důse	d u: s e
důstojne	d u: s t o j n e
džinech	d Z I n e x
džiny	d Z I n I
economcký	e t_s o n o m t_s k i:
eho	e h\ o
ekonomicke	e k o n o m I t_s k e
email	e m a I l
emaly	e m a l I
emoci	e m o t_s I
encykopedií	e n t_s I k o p e J\ I i:
estli	e s t l I
evropskych	e v r o p s k I x
evropán	e v r o p a: n
existovatve	e I s t o v a t v e
existuji	e I s t u j I
exurze	e u r z e
fakulte	f a k u l t e
fascinuji	f a s t_s I n u j I
finánčních	f I n a: n t_S J i: x
fizickou	f I z I t_s k o_u
fizika	f I z I k a
fizycká	f I z I t_s k a:
formalnějí	f o r m a l J e j i:
fotografíe	f o t o g r a f i: e
fotográfii	f o t o g r a: f I I
fotohrafie	f o t o h\ r a f I e
francouzkou	f r a n t_s o_u z k o_u
francouzký	f r a n t_s o_u z k i:
fungovát	f u N g o v a: t
fungujíci	f u N g u j i: t_s I
gde	g d e
gdiž	g J\ I S
gdyž	g d I S
gdíz	g J\ i: s
gramaticu	g r a m a c I t_s u
gramatíku	g r a m a c i: k u
gumanitarný	g u m a J I t a r n i:
gymnazia	g I m n a z I a
hajít	h\ a j i: t
havarie	h\ a v a r I e
hazim	h\ a z I m
heska	h\ e s k a
heske	h\ e s k e
heskou	h\ e s k o_u
heské	h\ e s k e:
heský	h\ e s k i:
hezka	h\ e z k a
hezke	h\ e z k e
hezkeho	h\ e z k e h\ o
hezky	h\ e z k I
hezký	h\ e z k i:
hežký	h\ e Z k i:
historicke	h\ I s t o r I t_s k e
hlasi	h\ l a s I
hlavne	h\ l a v n e
hlavní	h\ l a v J i:
hlavý	h\ l a v i:
hleda	h\ l e d a
hledal	h\ l e d a l
hledam	h\ l e d a m
hledame	h\ l e d a m e
hledíska	h\ l e J\ i: s k a
hlouběj	h\ l o_u b j e j
hlás	h\ l a: s
hnedy	h\ n e d I
hnet	h\ n e t
hnizdo	h\ J I z d o
hodi	h\ o J\ I
hodině	h\ o J\ I J e
hodna	h\ o d n a
hodne	h\ o d n e
hodné	h\ o d n e:
hodňe	h\ o d J e
hory.Mátétaký	h\ o r I m a: t e: t a k i:
hrat	h\ r a t
hriště	h\ r I S c e
hromády	h\ r o m a: d I
hráji	h\ r a: j I
hríště	h\ r i: S c e
hudé	h\ u d e:
humanisticke	h\ u m a J I s c I t_s k e
hřiští	h\ P\ I S c i:
hříšti	h\ P\ i: S c I
hříště	h\ P\ i: S c e
idealní	I d e a l J i:
informaci	I n f o r m a t_s I
innováčního	I n o v a: t_S J i: h\ o
inspirováná	I n s p I r o v a: n a:
intelektualní	I n t e l e k t u a l J i:
intellektualního	I n t e l l e k t u a l J i: h\ o
inzerat	I n z e r a t
inžiněru	I n Z I J e r u
ipratele	I p r a t e l e
irodína	I r o J\ i: n a
italů	I t a l u:
ja	j a
jahro	j a h\ r o
jak	j a k
jaka	j a k a
jake	j a k e
jakekoliv	j a k e k o l I f
jakem	j a k e m
jakesí	j a k e s i:
jasyku	j a s I k u
jazik	j a z I k
jaziku	j a z I k u
jazyki	j a z I k I
jazýkem	j a z i: k e m
jdí	j J\ i:
je	j e
jed	j e t
jedenkrat	j e d e N k r a t
jedincu	j e J\ I n t_s u
jediněný	j e J\ I J e n i:
jedne	j e d n e
jednoducha	j e d n o d u x a
jednoduche	j e d n o d u x e
jednodušé	j e d n o d u S e:
jednostráné	j e d n o s t r a: n e:
jedném	j e d n e: m
jedným	j e d n i: m
jedíny	j e J\ i: n I
jedíný	j e J\ i: n i:
jeji	j e j I
jejích	j e j i: x
jelá	j e l a:
jen	j e n
jenom	j e n o m
jeskýně	j e s k i: J e
jesli	j e s l I
jestly	j e s t l I
jestlí	j e s t l i:
jestě	j e s c e
jeto	j e t o
jezdi	j e z J\ I
jezdim	j e z J\ I m
ješte	j e S t e
ješté	j e S t e:
ještě	j e S c e
ji	j I
jicestovat	j I t_s e s t o v a t
jidla	j I d l a
jidlo	j I d l o
jin	j I n
jine	j I n e
jini	j I J I
jiny	j I n I
jinych	j I n I x
jinym	j I n I m
jist	j I s t
jista	j I s t a
jit	j I t
jizdenka	j I z d e N k a
jizdenku	j I z d e N k u
jizdenky	j I z d e N k I
jizdě	j I z J\ e
jmeno	j m e n o
jnom	j n o m
jse	j s e
jsem	j s e m
ják	j a: k
jázyky	j a: z I k I
jét	j e: t
jídeme	j i: d e m e
jíhu	j i: h\ u
jím	j i: m
jínak	j i: n a k
jínymí	j i: n I m i:
jínákost	j i: n a: k o s t
jíné	j i: n e:
jíného	j i: n e: h\ o
jíný	j i: n i:
jíných	j i: n i: x
jístotu	j i: s t o t u
jístá	j i: s t a:
jístě	j i: s c e
jě	j j e
jěště	j j e S c e
k	k
kRasny	k r a s n I
kRatké	k r a t k e:
kafé	k a f e:
kalohty	k a l o h\ t I
kamarad	k a m a r a t
kamaradami	k a m a r a d a m I
kamaradem	k a m a r a d e m
kamaradi	k a m a r a J\ I
kamaradka	k a m a r a d k a
kamaradkou	k a m a r a d k o_u
kamaradky	k a m a r a d k I
kamarady	k a m a r a d I
kamaradí	k a m a r a J\ i:
kamaradý	k a m a r a d i:
kamaradů	k a m a r a d u:
kamarádu	k a m a r a: d u
kamarátku	k a m a r a: t k u
kameradem	k a m e r a d e m
kamerádkou	k a m e r a: d k o_u
kamáradů	k a m a: r a d u:
kamáráda	k a m a: r a: d a
kamárádi	k a m a: r a: J\ I
kancelaři	k a n t_s e l a P\ I
kancelařskí	k a n t_s e l a P\ s k i:
kariera	k a r I e r a
karieře	k a r I e P\ e
karticky	k a r c I t_s k I
kavane	k a v a n e
kavarny	k a v a r n I
kavarně	k a v a r J e
kavu	k a v u
kaváně	k a v a: J e
kavú	k a v u:
kazdy	k a z d I
kazdý	k a z d i:
każdému	k a d e: m u
každa	k a Z d a
každe	k a Z d e
každeho	k a Z d e h\ o
každem	k a Z d e m
každnecho	k a Z d n e x o
každodeního	k a Z d o d e J i: h\ o
každodením	k a Z d o d e J i: m
každy	k a Z d I
kdy	g d I
kdyz	g d I s
kdyš	g d I S
kdé	g d e:
kdýz	g d i: s
kemně	k e m J e
klídu	k l i: d u
knihovne	k J I h\ o v n e
knihovňe	k J I h\ o v J e
kod	k o t
kolač	k o l a t_S
kolače	k o l a t_S e
kolegi	k o l e g I
kolektivemu	k o l e k c I v e m u
koliv	k o l I f
koláce	k o l a: t_s e
kolík	k o l i: k
kommunikace	k o m m u J I k a t_s e
komplikováných	k o m p l I k o v a: n i: x
komu	k o m u
komunicace	k o m u J I t_s a t_s e
komunikacní	k o m u J I k a t_s J i:
koncim	k o n t_s I m
koncím	k o n t_s i: m
konec	k o n e t_s
konfrontovan	k o n f r o n t o v a n
koničky	k o J I t_S k I
konkretnim	k o N k r e t J I m
konkretné	k o N k r e t n e:
konkretném	k o N k r e t n e: m
konkretní	k o N k r e t J i:
kontáktovat	k o n t a: k t o v a t
konát	k o n a: t
konči	k o n t_S I
končim	k o n t_S I m
korůn	k o r u: n
koupovat	k o_u p o v a t
koupít	k o_u p i: t
kousiček	k o_u s I t_S e k
kočarekou	k o t_S a r e k o_u
kralovství	k r a l o v s t v i:
krasny	k r a s n I
krasná	k r a s n a:
krasné	k r a s n e:
krasných	k r a s n i: x
krasně	k r a s J e
krat	k r a t
kratke	k r a t k e
kratké	k r a t k e:
kratkém	k r a t k e: m
kratkých	k r a t k i: x
kriterií	k r I t e r I i:
krostlime	k r o s t l I m e
krásny	k r a: s n I
krásnych	k r a: s n I x
krásné	k r a: s n e:
krát	k r a: t
krátke	k r a: t k e
ktera	k t e r a
ktere	k t e r e
ktereho	k t e r e h\ o
kterem	k t e r e m
ktery	k t e r I
kterych	k t e r I x
kterymi	k t e r I m I
kterí	k t e r i:
který	k t e r i:
kterýmy	k t e r i: m I
kteři	k t e P\ I
kteřími	k t e P\ i: m I
kteřý	k t e P\ i:
kto	k t o
ktére	k t e: r e
ktérem	k t e: r e m
ktéry	k t e: r I
ktérých	k t e: r i: x
ktěra	k c e r a
kuchyne	k u x I n e
kuchýni	k u x i: J I
kultuřou	k u l t u P\ o_u
kupujici	k u p u j I t_s I
kurzi	k u r z I
kurzéch	k u r z e: x
kusek	k u s e k
kvalítní	k v a l i: t J i:
kám	k a: m
kámaráda	k a: m a r a: d a
káždého	k a: Z d e: h\ o
káždý	k a: Z d i:
kím	k i: m
kíno	k i: n o
kžady	k Z a d I
laska	l a s k a
laskou	l a s k o_u
lasky	l a s k I
latek	l a t e k
le	l e
legračni	l e g r a t_S J I
lehší	l e h\ S i:
lehšší	l e h\ S S i:
lekařa	l e k a P\ a
lekařské	l e k a P\ s k e:
lekařů	l e k a P\ u:
lepe	l e p e
lepsí	l e p s i:
lepé	l e p e:
lepši	l e p S I
lepšim	l e p S I m
let	l e t
lete	l e t e
leto	l e t o
letát	l e t a: t
leté	l e t e:
letéch	l e t e: x
letě	l e c e
levne	l e v n e
levnějši	l e v J e j S I
leži	l e Z I
li	l I
libi	l I b I
libilo	l I b I l o
libí	l I b i:
libíl	l I b i: l
libímy	l I b i: m I
libít	l I b i: t
lide	l I d e
lidi	l I J\ I
lidmí	l I d m i:
lidove	l I d o v e
lidém	l I d e: m
lidí	l I J\ i:
lidě	l I J\ e
lip	l I p
lito	l I t o
luksusní	l u k s u s J i:
luksusním	l u k s u s J i: m
lyžarskou	l I Z a r s k o_u
lyžarškou	l I Z a r S k o_u
lyžařska	l I Z a P\ s k a
lyžováný	l I Z o v a: n i:
lépé	l e: p e:
létá	l e: t a:
líde	l i: d e
lídi	l i: J\ I
lídmi	l i: d m I
lídmí	l i: d m i:
lídé	l i: d e:
lídí	l i: J\ i:
lísty	l i: s t I
líteratura	l i: t e r a t u r a
líteraturu	l i: t e r a t u r u
líší	l i: S i:
lěto	l j e t o
lětě	l j e c e
ma	m a
maji	m a j I
majítelech	m a j i: t e l e x
maksimalně	m a k s I m a l J e
maleho	m a l e h\ o
mali	m a l I
malo	m a l o
maly	m a l I
malá	m a l a:
mam	m a m
mame	m a m e
mamotazky	m a m o t a z k I
mamy	m a m I
manažér	m a n a Z e: r
manžěla	m a n Z j e l a
mate	m a t e
material	m a t e r I a l
mateřčina	m a t e P\ t_S I n a
mathematiky	m a t h\ e m a c I k I
matimatice	m a c I m a c I t_s e
maturítní	m a t u r i: t J i:
maš	m a S
me	m e
medialním	m e J\ I a l J i: m
meho	m e h\ o
mej	m e j
melí	m e l i:
mem	m e m
meně	m e J e
mesice	m e s I t_s e
mesto	m e s t o
mezilidskich	m e z I l I d s k I x
mezí	m e z i:
miesto	m I e s t o
mila	m I l a
mini-sukne	m I J I s u k n e
minimalně	m I J I m a l J e
minuly	m I n u l I
mislým	m I s l i: m
mist	m I s t
misto	m I s t o
mistě	m I s c e
mit	m I t
mladi	m= l a J\ I
mladycn	m= l a d I t_s n
mladši	m= l a d S I
mluvi	m= l u v I
mluvít	m= l u v i: t
mládí	m= l a: J\ i:
mládý	m= l a: d i:
mládých	m= l a: d i: x
mlůvit	m= l u: v I t
mnohokrat	m= n o h\ o k r a t
mnohym	m= n o h\ I m
mnohém	m= n o h\ e: m
mnohó	m= n o h\ o:
mnóho	m= n o: h\ o
mněl	m= n j e l
moc	m o t_s
mockrat	m o t_s k r a t
modernícho	m o d e r J i: x o
modní	m o d J i:
mody	m o d I
mohla	m o h\ l a
mohly	m o h\ l I
mojé	m o j e:
motivovanejší	m o c I v o v a n e j S i:
mozne	m o z n e
mozností	m o z n o s c i:
mozná	m o z n a:
mozné	m o z n e:
mozně	m o z J e
mořskí	m o P\ s k i:
možna	m o Z n a
možne	m o Z n e
možnosti	m o Z n o s c I
možností	m o Z n o s c i:
muj	m u j
museji	m u s e j I
museš	m u s e S
musi	m u s I
musim	m u s I m
musime	m u s I m e
muz	m u s
muze	m u z e
muzů	m u z u:
mušežmě	m u S e Z m J e
muže	m u Z e
mužeme	m u Z e m e
mužes	m u Z e s
mužete	m u Z e t e
mužeš	m u Z e S
mužne	m u Z n e
mužou	m u Z o_u
mužu	m u Z u
mylila	m I l I l a
mylit	m I l I t
mynuleho	m I n u l e h\ o
mysli	m I s l I
myslim	m I s l I m
myslíla	m I s l i: l a
myšlet	m I S l e t
máji	m a: j I
májí	m a: j i:
mála	m a: l a
mám	m a: m
máminka	m a: m I N k a
más	m a: s
másíme	m a: s i: m e
mátka	m a: t k a
mátky	m a: t k I
mí	m i:
míli	m i: l I
mílost	m i: l o s t
mílou	m i: l o_u
mílého	m i: l e: h\ o
mím	m i: m
mín	m i: n
mínulý	m i: n u l i:
mý	m i:
mýslenka	m i: s l e N k a
mýslet	m i: s l e t
mýsli	m i: s l I
mýslit	m i: s l I t
mýslím	m i: s l i: m
mýšlenku	m i: S l e N k u
mě	m J e
mělby	m J e l b I
mělibychom	m J e l I b I x o m
mělí	m J e l i:
měm	m J e m
měne	m J e n e
měsic	m J e s I t_s
měsica	m J e s I t_s a
měsice	m J e s I t_s e
měsiců	m J e s I t_s u:
měste	m J e s t e
městké	m J e s t k e:
město	m J e s t o
městá	m J e s t a:
mů	m u:
můsi	m u: s I
můsí	m u: s i:
můsím	m u: s i: m
můze	m u: z e
můzem	m u: z e m
můzeš	m u: z e S
můzu	m u: z u
můž	m u: S
můžes	m u: Z e s
mˇaš	m a S
na	n a
nabidka	n a b I d k a
nabidkou	n a b I d k o_u
nabidku	n a b I d k u
nabidla	n a b I d l a
nabidne	n a b I d n e
nabitnout	n a b I t n o_u t
nabízete	n a b i: z e t e
nabízi	n a b i: z I
nabřeži	n a b P\ e Z I
nadavaji	n a d a v a j I
nadmorskou	n a d m o r s k o_u
nadobi	n a d o b I
nadrazi	n a d r a z I
nadraži	n a d r a Z I
nadraží	n a d r a Z i:
nadráží	n a d r a: Z i:
nahodou	n a h\ o d o_u
naidu	n a I d u
najit	n a j I t
najvic	n a j v I t_s
naladu	n a l a d u
nalezt	n a l e z t
nam	n a m
nami	n a m I
namáhavy	n a m a: h\ a v I
naopák	n a o p a: k
napad	n a p a t
napadem	n a p a d e m
napis	n a p I s
napišeš	n a p I S e S
napišu	n a p I S u
napsala	n a p s a l a
napsát	n a p s a: t
napíseš	n a p i: s e S
napíš	n a p i: S
napíšte	n a p i: S t e
napřiklad	n a p Q\ I k l a t
narodi	n a r o J\ I
narodíl	n a r o J\ i: l
narožení	n a r o Z e J i:
naroženín	n a r o Z e J i: n
nas	n a s
nase	n a s e
nasi	n a s I
nasich	n a s I x
naspět	n a s p j e t
nastěvuje	n a s c e v u j e
nasí	n a s i:
naučili	n a_u t_S I l I
naučíla	n a_u t_S i: l a
naučít	n a_u t_S i: t
navstivit	n a v s c I v I t
navstívim	n a v s c i: v I m
navstívit	n a v s c i: v I t
navstěvujes	n a v s c e v u j e s
navstěvuju	n a v s c e v u j u
navštevovát	n a v S t e v o v a: t
navštevě	n a v S t e v j e
navštěva	n a v S c e v a
navštěvu	n a v S c e v u
nazo	n a z o
nazor	n a z o r
nazoru	n a z o r u
nazorý	n a z o r i:
nazorů	n a z o r u:
naúčit	n a u: t_S I t
naš	n a S
našého	n a S e: h\ o
našém	n a S e: m
ne	n e
nebo	n e b o
nebydléli	n e b I d l e: l I
nechtejí	n e x t e j i:
nechtela	n e x t e l a
nechtěji	n e x c e j I
necitím	n e t_s I c i: m
neco	n e t_s o
nedokazal	n e d o k a z a l
nedokazaly	n e d o k a z a l I
nedostané	n e d o s t a n e:
nedívam	n e J\ i: v a m
neho	n e h\ o
nej	n e j
nejake	n e j a k e
nejakem	n e j a k e m
nejakoho	n e j a k o h\ o
nejakou	n e j a k o_u
nejaky	n e j a k I
nejaká	n e j a k a:
nejaké	n e j a k e:
nejakého	n e j a k e: h\ o
nejakú	n e j a k u:
nejaký	n e j a k i:
nejbližši	n e j b l I Z S I
nejblížších	n e j b l i: Z S i: x
nejblížšího	n e j b l i: Z S i: h\ o
nejduležitejši	n e j d u l e Z I t e j S I
nejduležitejší	n e j d u l e Z I t e j S i:
nejduležitější	n e j d u l e Z I c e j S i:
nejdřiv	n e j d P\ I f
nejdřívé	n e j d P\ i: v e:
nejdůležitejši	n e j d u: l e Z I t e j S I
nejdůležitejší	n e j d u: l e Z I t e j S i:
nejdůležitěší	n e j d u: l e Z I c e S i:
nejdůležítějši	n e j d u: l e Z i: c e j S I
nejdůležítější	n e j d u: l e Z i: c e j S i:
nejkrasnejsí	n e j k r a s n e j s i:
nejlepe	n e j l e p e
nejlepé	n e j l e p e:
nejlepši	n e j l e p S I
nejnakážlivější	n e j n a k a: Z l I v j e j S i:
nejradiěji	n e j r a J\ I j e j I
nejvetši	n e j v e t S I
nejvyznamnější	n e j v I z n a m J e j S i:
nejvzdelanejši	n e j v z d e l a n e j S I
největšich	n e j v j e t S I x
nejákym	n e j a: k I m
nejčasteji	n e j t_S a s t e j I
nekaždy	n e k a Z d I
nekaždý	n e k a Z d i:
nekolik	n e k o l I k
nekterými	n e k t e r i: m I
nekteří	n e k t e P\ i:
nelibi	n e l I b I
nema	n e m a
nemaji	n e m a j I
nemam	n e m a m
nemaš	n e m a S
nemit	n e m I t
nemocna	n e m o t_s n a
nemusi	n e m u s I
nemuže	n e m u Z e
nemužeme	n e m u Z e m e
nemužete	n e m u Z e t e
nemužou	n e m u Z o_u
nemužu	n e m u Z u
nemčině	n e m t_S I J e
nemůsí	n e m u: s i:
nemůze	n e m u: z e
nemůzu	n e m u: z u
nenahrádi	n e n a h\ r a: J\ I
nenajit	n e n a j I t
nenapisala	n e n a p I s a l a
neni	n e J I
neobejdéme	n e o b e j d e: m e
neobéjdeme	n e o b e: j d e m e
nepečujicí	n e p e t_S u j I t_s i:
neplátí	n e p l a: c i:
nepodívalí	n e p o J\ i: v a l i:
nepomatovala	n e p o m a t o v a l a
neposluchaji	n e p o s l u x a j I
nepotřebovát	n e p o t Q\ e b o v a: t
nepoužiji	n e p o_u Z I j I
nepřijemná	n e p Q\ I j e m n a:
nepřijemně	n e p Q\ I j e m J e
nepříde	n e p Q\ i: d e
nepříjít	n e p Q\ i: j i: t
nereálna	n e r e a: l n a
nervozná	n e r v o z n a:
nervozní	n e r v o z J i:
nespravne	n e s p r a v n e
nespravný	n e s p r a v n i:
nest	n e s t
nestači	n e s t a t_S I
nesšastny	n e s S a s t n I
nesťastný	n e s c a s t n i:
netyká	n e t I k a:
neudelá	n e_u d e l a:
neuděla	n e_u J\ e l a
neudělame	n e_u J\ e l a m e
neuděláté	n e_u J\ e l a: t e:
neumila	n e_u m I l a
neuplné	n e_u p l= n e:
neustale	n e_u s t a l e
neustalé	n e_u s t a l e:
neuvídí	n e_u v i: J\ i:
neuvídíme	n e_u v i: J\ i: m e
nevadi	n e v a J\ I
neveřím	n e v e P\ i: m
nevi	n e v I
nevidim	n e v I J\ I m
nevidṙží	n e v I d Z i:
nevim	n e v I m
nevydeláš	n e v I d e l a: S
nevyděla	n e v I J\ e l a
nevyhody	n e v I h\ o d I
nevídí	n e v i: J\ i:
nevídíme	n e v i: J\ i: m e
nevýspělých	n e v i: s p j e l i: x
nevždycky	n e v Z d I t_s k I
nezaleží	n e z a l e Z i:
nezamená	n e z a m e n a:
nezapomnout	n e z a p o m n o_u t
nezavidí	n e z a v I J\ i:
nezbytne	n e z b I t n e
nezbyvá	n e z b I v a:
neziskáme	n e z I s k a: m e
neznamena	n e z n a m e n a
neznamenájy	n e z n a m e n a: j I
neznamích	n e z n a m i: x
neznájí	n e z n a: j i:
nečem	n e t_S e m
nečim	n e t_S I m
nečím	n e t_S i: m
nešťastého	n e S c a s t e: h\ o
ni	J I
nim	J I m
nimž	J I m S
ničim	J I t_S I m
niž	J I S
normalní	n o r m a l J i:
normalně	n o r m a l J e
norský	n o r s k i:
nouzí	n o_u z i:
nove	n o v e
novinach	n o v I n a x
novych	n o v I x
novymí	n o v I m i:
nríšel	n r i: S e l
nudi	n u J\ I
nutne	n u t n e
nutít	n u c i: t
ná	n a:
nádraži	n a: d r a Z I
náproti	n a: p r o c I
národilá	n a: r o J\ I l a:
národit	n a: r o J\ I t
nárození	n a: r o z e J i:
náse	n a: s e
náše	n a: S e
náši	n a: S I
né	n e:
némocná	n e: m o t_s n a:
níc	J i: t_s
ních	J i: x
níkde	J i: g d e
níkdo	J i: g d o
níkdy	J i: g d I
ním	J i: m
níma	J i: m a
ními	J i: m I
nóva	n o: v a
něcím	J e t_s i: m
nějaka	J e j a k a
nějake	J e j a k e
nějakeho	J e j a k e h\ o
nějaky	J e j a k I
nějlepším	J e j l e p S i: m
několikrat	J e k o l I k r a t
několík	J e k o l i: k
někteři	J e k t e P\ I
někám	J e k a: m
někí	J e k i:
někím	J e k i: m
němocní	J e m o t_s J i:
něčém	J e t_S e: m
nǐch	n x
o	o
obdobi	o b d o b I
obejit	o b e j I t
objevíly	o b j e v i: l I
oblec	o b l e t_s
oblecení	o b l e t_s e J i:
oblect	o b l e t_s t
oblekají	o b l e k a j i:
oblekat	o b l e k a t
oblekne	o b l e k n e
obleknout	o b l e k n o_u t
obleknu	o b l e k n u
obleká	o b l e k a:
oblečeni	o b l e t_S e J I
oblečenim	o b l e t_S e J I m
oblibene	o b l I b e n e
oblibené	o b l I b e n e:
oblibenějsim	o b l I b e J e j s I m
oblivenejší	o b l I v e n e j S i:
obličenim	o b l I t_S e J I m
obličení	o b l I t_S e J i:
obličenů	o b l I t_S e n u:
oblásti	o b l a: s c I
obojí	o b o j i:
obratít	o b r a c i: t
obrazku	o b r a z k u
obražky	o b r a Z k I
obrácím	o b r a: t_s i: m
obsázovat	o b s a: z o v a t
obvikle	o b v I k l e
obyjit	o b I j I t
obytnem	o b I t n e m
obyvatele	o b I v a t e l e
obyčejneho	o b I t_S e j n e h\ o
obzlvašt	o b z l= v a S t
občás	o b t_S a: s
obědnat	o b j e d n a t
obův	o b u: f
oceňujé	o t_s e J u j e:
odehrava	o d e h\ r a v a
odev	o d e f
odevsdala	o d e v s d a l a
odjdou	o d j d o_u
odjědu	o d j j e d u
odmitnutí	o d m I t n u c i:
odpolednu	o d p o l e d n u
odpoledné	o d p o l e d n e:
odpověd	o d p o v j e t
odpovědne	o d p o v j e d n e
odpočiva	o d p o t_S I v a
odpočivaj	o d p o t_S I v a j
odpočivaji	o d p o t_S I v a j I
odpočivají	o d p o t_S I v a j i:
odpočival	o d p o t_S I v a l
odpočivam	o d p o t_S I v a m
odpočivaní	o d p o t_S I v a J i:
odpočivat	o d p o t_S I v a t
odpočivá	o d p o t_S I v a:
odpočnout	o d p o t_S n o_u t
odpočívaji	o d p o t_S i: v a j I
odprácovavat	o d p r a: t_s o v a v a t
odstinu	o d s c I n u
odstiny	o d s c I n I
odvěka	o d v j e k a
oděva	o J\ e v a
ohiňěk	o h\ I J j e k
okamžík	o k a m Z i: k
oní	o J i:
oníbudou	o J i: b u d o_u
opravdovych	o p r a v d o v I x
opustime	o p u s c I m e
opuští	o p u S c i:
oslávíme	o s l a: v i: m e
osmileteho	o s m I l e t e h\ o
osobí	o s o b i:
ostatni	o s t a t J I
ostátních	o s t a: t J i: x
otazek	o t a z e k
otazka	o t a z k a
otazku	o t a z k u
otazky	o t a z k I
otažku	o t a Z k u
otravujici	o t r a v u j I t_s I
ovl-ambiguous-vnjuje	o v l= a m b I g u o_u s v n j u j e
ovlivneny	o v l I v n e n I
oznamil	o z n a m I l
očekavat	o t_S e k a v a t
očekávana	o t_S e k a: v a n a
ošklívé	o S k l i: v e:
padesatt	p a d e s a t
pameť	p a m e c
památkamí	p a m a: t k a m i:
pana	p a n a
pani	p a J I
panové	p a n o v e:
par	p a r
parkovište	p a r k o v I S t e
parkovíšti	p a r k o v i: S c I
patRe	p a t r e
patek	p a t e k
patku	p a t k u
patý	p a t i:
pekny	p e k n I
pekné	p e k n e:
pekně	p e k J e
peniz	p e J I s
peniza	p e J I z a
penize	p e J I z e
peniže	p e J I Z e
penízé	p e J i: z e:
penězěnky	p e J e z j e N k I
perfectní	p e r f e t_s t J i:
pilny	p I l n I
pirvní	p I r v J i:
piseš	p I s e S
pisku	p I s k u
pisničky	p I s J I t_S k I
piti	p I c I
pišeš	p I S e S
pišou	p I S o_u
pišu	p I S u
planovat	p l a n o v a t
planuješ	p l a n u j e S
planujou	p l a n u j o_u
planuju	p l a n u j u
plany	p l a n I
plati	p l a c I
platít	p l a c i: t
plavi	p l a v I
plať	p l a c
plaž	p l a S
plaži	p l a Z I
pobavít	p o b a v i: t
pocasí	p o t_s a s i:
pochazi	p o x a z I
pochazí	p o x a z i:
pochazím	p o x a z i: m
pochvalen	p o x v a l e n
podceńovat	p o d t_s e o v a t
podivat	p o J\ I v a t
podiváme	p o J\ I v a: m e
podlě	p o d l j e
podminkou	p o d m I N k o_u
podminkách	p o d m I N k a: x
podminký	p o d m I N k i:
podnebi	p o d n e b I
podobne	p o d o b n e
podpadkem	p o d p a d k e m
podporovalí	p o d p o r o v a l i:
podporovát	p o d p o r o v a: t
podpořujepodpořuje	p o d p o P\ u j e p o d p o P\ u j e
podstate	p o d s t a t e
pohadku	p o h\ a d k u
pohledam	p o h\ l e d a m
pojedů	p o j e d u:
pokládaš	p o k l a: d a S
pokojí	p o k o j i:
pokračovála	p o k r a t_S o v a: l a
pokračuvat	p o k r a t_S u v a t
pokud	p o k u t
politicy	p o l I c I t_s I
pomachat	p o m a x a t
pomaha	p o m a h\ a
pomahají	p o m a h\ a j i:
pomahalí	p o m a h\ a l i:
pomahat	p o m a h\ a t
pomahá	p o m a h\ a:
pomuže	p o m u Z e
pomužou	p o m u Z o_u
pomáha	p o m a: h\ a
pomáhažakům	p o m a: h\ a Z a k u: m
pomálu	p o m a: l u
pomóhl	p o m o: h\ l=
poněvaď	p o J e v a c
popovídát	p o p o v i: d a: t
popularitá	p o p u l a r I t a:
poradít	p o r a J\ i: t
porovnávát	p o r o v n a: v a: t
porozumněla	p o r o z u m J e l a
porádit	p o r a: J\ I t
porádné	p o r a: d n e:
posilala	p o s I l a l a
posilat	p o s I l a t
poskitne	p o s k I t n e
posledny	p o s l e d n I
posleš	p o s l e S
posloucha	p o s l o_u x a
posluchat	p o s l u x a t
pospíchame	p o s p i: x a m e
postavít	p o s t a v i: t
postgradual	p o s t g r a d u a l
postgradualný	p o s t g r a d u a l n i:
posílam	p o s i: l a m
potesili	p o t e s I l I
potiže	p o c I Z e
potkávam	p o t k a: v a m
potrebovala	p o t r e b o v a l a
potrebovat	p o t r e b o v a t
potrebuje	p o t r e b u j e
potrebuju	p o t r e b u j u
potrva	p o t r= v a
potřebuji	p o t Q\ e b u j I
potřebujéme	p o t Q\ e b u j e: m e
pouzívají	p o_u z i: v a j i:
použivaji	p o_u Z I v a j I
použivají	p o_u Z I v a j i:
použivame	p o_u Z I v a m e
používa	p o_u Z i: v a
používát	p o_u Z i: v a: t
povidaji	p o v I d a j I
povolaní	p o v o l a J i:
povídát	p o v i: d a: t
pozdeji	p o z d e j I
pozdně	p o z d J e
pozdravý	p o z d r a v i:
pozdějí	p o z J\ e j i:
poznalí	p o z n a l i:
poznavam	p o z n a v a m
poznavá	p o z n a v a:
poznaváme	p o z n a v a: m e
poznaš	p o z n a S
poználi	p o z n a: l I
poznás	p o z n a: s
poznát	p o z n a: t
poznávát	p o z n a: v a: t
pozvani	p o z v a J I
pozvanku	p o z v a N k u
pozvaní	p o z v a J i:
pozváni	p o z v a: J I
počasi	p o t_S a s I
počit	p o t_S I t
počitat	p o t_S I t a t
počitače	p o t_S I t a t_S e
počitačem	p o t_S I t a t_S e m
počitači	p o t_S I t a t_S I
počitačům	p o t_S I t a t_S u: m
pořad	p o P\ a t
pořadku	p o P\ a d k u
pořadně	p o P\ a d J e
pořidíla	p o P\ I J\ i: l a
pořizovaní	p o P\ I z o v a J i:
pořátku	p o P\ a: t k u
požadávkách	p o Z a d a: v k a: x
poždeji	p o Z d e j I
poždě	p o Z J\ e
pra	p r a
prace	p r a t_s e
praceschopná	p r a t_s e s x o p n a:
praci	p r a t_s I
pracovál	p r a t_s o v a: l
pracé	p r a t_s e:
prací	p r a t_s i:
pracóvat	p r a t_s o: v a t
pratele	p r a t e l e
pravdive	p r a v J\ I v e
pravdu	p r a v d u
pravděbodobně	p r a v J\ e b o d o b J e
pravit	p r a v I t
pravnici	p r a v J I t_s I
pravníckou	p r a v J i: t_s k o_u
pravo	p r a v o
pravě	p r a v j e
prazdninové	p r a z d J I n o v e:
prazdninovéch	p r a z d J I n o v e: x
prazdninách	p r a z d J I n a: x
predevším	p r e d e v S i: m
predměty	p r e d m J e t I
predpoklady	p r e d p o k l a d I
predu	p r e d u
premie	p r e m I e
prepsat	p r e p s a t
pres	p r e s
pretože	p r e t o Z e
pribeh	p r I b e x
pridat	p r I d a t
prijdu	p r I j d u
prijemné	p r I j e m n e:
prijet	p r I j e t
prinášet	p r I n a: S e t
pripadů	p r I p a d u:
pripravení	p r I p r a v e J i:
prisloví	p r I s l o v i:
pritele	p r I t e l e
privatní	p r I v a t J i:
privní	p r I v J i:
pro	p r o
probihá	p r o b I h\ a:
problem	p r o b l e m
problemu	p r o b l e m u
problemy	p r o b l e m I
problemů	p r o b l e m u:
problemům	p r o b l e m u: m
probíha	p r o b i: h\ a
proc	p r o t_s
process	p r o t_s e s
prochazku	p r o x a z k u
prochazky	p r o x a z k I
profesionalní	p r o f e s I o n a l J i:
prohazku	p r o h\ a z k u
prohližet	p r o h\ l I Z e t
prominte	p r o m I n t e
promněnami	p r o m J e n a m I
promóvat	p r o m o: v a t
pronajatem	p r o n a j a t e m
prosim	p r o s I m
prospěrují	p r o s p j e r u j i:
prostredki	p r o s t r e d k I
proto	p r o t o
protoze	p r o t o z e
protože	p r o t o Z e
provadet	p r o v a d e t
proč	p r o t_S
prožíju	p r o Z i: j u
prožílá	p r o Z i: l a:
prožíva	p r o Z i: v a
prumyslů	p r u m I s l u:
prve	p r= v e
prvnima	p r= v J I m a
pryrodu	p r I r o d u
práci	p r a: t_s I
prácovat	p r a: t_s o v a t
prácovní	p r a: t_s o v J i:
prácuje	p r a: t_s u j e
prácuji	p r a: t_s u j I
prácuju	p r a: t_s u j u
prácí	p r a: t_s i:
práles	p r a: l e s
prásdninam	p r a: s d J I n a m
práteli	p r a: t e l I
prátelství	p r a: t e l s t v i:
právda	p r a: v d a
právdu	p r a: v d u
právnik	p r a: v J I k
právnikem	p r a: v J I k e m
prázdninove	p r a: z d J I n o v e
prázdninovem	p r a: z d J I n o v e m
prázdnymi	p r a: z d n I m I
príjet	p r i: j e t
prírodu	p r i: r o d u
prísloví	p r i: s l o v i:
prítele	p r i: t e l e
príšel	p r i: S e l
prěd	p r j e t
prěslo	p r j e s l o
pržet	p r= Z e t
psat	p s a t
psichologie	p s I x o l o g I e
psá	p s a:
pujde	p u j d e
pujdu	p u j d u
pádesatkrát	p a: d e s a t k r a: t
pák	p a: k
pártner	p a: r t n e r
péníze	p e: J i: z e
pílně	p i: l J e
pěkne	p j e k n e
pěknie	p j e k J I e
pěkny	p j e k n I
pěty	p j e t I
pŘidou	p I d o_u
přatela	p Q\ a t e l a
přatelami	p Q\ a t e l a m I
přatele	p Q\ a t e l e
přatelem	p Q\ a t e l e m
přatelskym	p Q\ a t e l s k I m
přatelstvi	p Q\ a t e l s t v I
přatelství	p Q\ a t e l s t v i:
přatelsčí	p Q\ a t e l s t_S i:
přatelé	p Q\ a t e l e:
přatelí	p Q\ a t e l i:
přatéle	p Q\ a t e: l e
přecházime	p Q\ e x a: z I m e
přecíst	p Q\ e t_s i: s t
předavat	p Q\ e d a v a t
předevšim	p Q\ e d e v S I m
předmetu	p Q\ e d m e t u
předstáva	p Q\ e d s t a: v a
přejes	p Q\ e j e s
překladala	p Q\ e k l a d a l a
překvapění	p Q\ e k v a p j e J i:
přemyslet	p Q\ e m I s l e t
přemysli	p Q\ e m I s l I
přemyšlejících	p Q\ e m I S l e j i: t_s i: x
přemyšlelá	p Q\ e m I S l e l a:
přemyšlet	p Q\ e m I S l e t
přemyšlám	p Q\ e m I S l a: m
přemyšlí	p Q\ e m I S l i:
přesne	p Q\ e s n e
přesvjedčení	p Q\ e s v j e d t_S e J i:
převažne	p Q\ e v a Z n e
přežíl	p Q\ e Z i: l
při	p Q\ I
přibeh	p Q\ I b e x
přibuzným	p Q\ I b u z n i: m
přichazet	p Q\ I x a z e t
přiele	p Q\ I e l e
přihlašku	p Q\ I h\ l a S k u
přijdéš	p Q\ I j d e: S
přijděs	p Q\ I j J\ e s
přijed	p Q\ I j e t
přijedes	p Q\ I j e d e s
přijemné	p Q\ I j e m n e:
přijemá	p Q\ I j e m a:
přijimací	p Q\ I j I m a t_s i:
přijimám.Pošli	p Q\ I j I m a: m p o S l I
přijit	p Q\ I j I t
přijiždí	p Q\ I j I Z J\ i:
přijmají	p Q\ I j m a j i:
přijt	p Q\ I j t
přijét	p Q\ I j e: t
přijědu	p Q\ I j j e d u
přiklad	p Q\ I k l a t
přikvápeni	p Q\ I k v a: p e J I
přiležitost	p Q\ I l e Z I t o s t
přinaši	p Q\ I n a S I
přinaší	p Q\ I n a S i:
přinest	p Q\ I n e s t
přinásíme	p Q\ I n a: s i: m e
připadlo	p Q\ I p a d l o
připadě	p Q\ I p a J\ e
připrava	p Q\ I p r a v a
připravenejší	p Q\ I p r a v e n e j S i:
připravou	p Q\ I p r a v o_u
připrávné	p Q\ I p r a: v n e:
přirodou	p Q\ I r o d o_u
přirodu	p Q\ I r o d u
přislovce	p Q\ I s l o v t_s e
přislovi	p Q\ I s l o v I
přislovim	p Q\ I s l o v I m
přislovu	p Q\ I s l o v u
přisloví	p Q\ I s l o v i:
přislovím	p Q\ I s l o v i: m
přislušníky	p Q\ I s l u S J i: k I
přisti	p Q\ I s c I
přitel	p Q\ I t e l
přitele	p Q\ I t e l e
přitelem	p Q\ I t e l e m
přitelkini	p Q\ I t e l k I J I
přitelkyni	p Q\ I t e l k I J I
přitelkýní	p Q\ I t e l k i: J i:
přitelskímpozdravem	p Q\ I t e l s k i: m p o z d r a v e m
přitomen	p Q\ I t o m e n
přišti	p Q\ I S c I
přiští	p Q\ I S c i:
přištý	p Q\ I S t i:
přkvapení	p Q\ k v a p e J i:
přo	p Q\ o
přsně	p Q\ s J e
přáni	p Q\ a: J I
přátele	p Q\ a: t e l e
přátelske	p Q\ a: t e l s k e
pří	p Q\ i:
příbeh	p Q\ i: b e x
příbehy	p Q\ i: b e h\ I
příjde	p Q\ i: j d e
příjdeme	p Q\ i: j d e m e
příjdeš	p Q\ i: j d e S
příjedeš	p Q\ i: j e d e S
příjedou	p Q\ i: j e d o_u
příjel	p Q\ i: j e l
příjetí	p Q\ i: j e c i:
příjíma	p Q\ i: j i: m a
příklade	p Q\ i: k l a d e
příležitostí	p Q\ i: l e Z I t o s c i:
přílíš	p Q\ i: l i: S
přínaší	p Q\ i: n a S i:
přínášet	p Q\ i: n a: S e t
případéch	p Q\ i: p a d e: x
přípravená	p Q\ i: p r a v e n a:
příslový	p Q\ i: s l o v i:
přístí	p Q\ i: s c i:
přítelém	p Q\ i: t e l e: m
přýtelkyní	p Q\ i: t e l k I J i:
r-ambiguous-ct	r a m b I g u o_u s t_s t
racionalně	r a t_s I o n a l J e
rad	r a t
rada	r a d a
radi	r a J\ I
radio	r a J\ I o
radosti	r a d o s c I
rady	r a d I
radá	r a d a:
radí	r a J\ i:
radějí	r a J\ e j i:
radší	r a d S i:
ramcíh	r a m t_s i: x
rano	r a n o
realizovát	r e a l I z o v a: t
reka	r e k a
relaxačni	r e l a a t_S J I
relaxuji	r e l a u j I
restaurace	r e s t a_u r a t_s e
rešení	r e S e J i:
rict	r I t_s t
rodice	r o J\ I t_s e
rodinny	r o J\ I n I
rodiná	r o J\ I n a:
rodiní	r o J\ I J i:
rodnem	r o d n e m
rodína	r o J\ i: n a
rodíči	r o J\ i: t_S I
rolí	r o l i:
romany	r o m a n I
rozdil	r o z J\ I l
rozdily	r o z J\ I l I
rozděli	r o z J\ e l I
rozšiřen	r o z S I P\ e n
rozšiřujicí	r o z S I P\ u j I t_s i:
ročne	r o t_S n e
rukavem	r u k a v e m
rutinni	r u c I n I
ruzne	r u z n e
ruznych	r u z n I x
ruzné	r u z n e:
ruzných	r u z n i: x
ruže	r u Z e
ružové	r u Z o v e:
ružový	r u Z o v i:
ry	r I
rychlejí	r I x l e j i:
rychlevařící	r I x l e v a P\ i: t_s i:
rychlějsí	r I x l j e j s i:
rádost	r a: d o s t
rádá	r a: d a:
rádí	r a: J\ i:
rádší	r a: d S i:
ríct	r i: t_s t
rýchléji	r i: x l e: j I
rčení	r= t_S e J i:
růze	r u: z e
různe	r u: z n e
různych	r u: z n I x
různymí	r u: z n I m i:
růžne	r u: Z n e
sabě	s a b j e
sam	s a m
samostatne	s a m o s t a t n e
samostatnejší	s a m o s t a t n e j S i:
samostátnost	s a m o s t a: t n o s t
samotnym	s a m o t n I m
samovyuky	s a m o v I u k I
samozreme	s a m o z r e m e
samozřejmně	s a m o z P\ e j m J e
samí	s a m i:
sandalie	s a n d a l I e
schledanou	s x l e d a n o_u
scháží	s x a: Z i:
se	s e
sebevzdělaní	s e b e v z J\ e l a J i:
sedívat	s e J\ i: v a t
sedům	s e d u: m
sem	s e m
seminarnich	s e m I n a r J I x
seminarní	s e m I n a r J i:
seminař	s e m I n a Q\
seminařní	s e m I n a P\ J i:
semínarní	s e m i: n a r J i:
servírki	s e r v i: r k I
setkali	s e t k a l I
setkam	s e t k a m
setkame	s e t k a m e
setkani	s e t k a J I
setkaní	s e t k a J i:
setkáli	s e t k a: l I
setkát	s e t k a: t
setkávam	s e t k a: v a m
seznamil	s e z n a m I l
seznamila	s e z n a m I l a
seznamily	s e z n a m I l I
seznámujeme	s e z n a: m u j e m e
sfer	s f e r
shortky	s h\ o r t k I
shromaždění	s h\ r o m a Z J\ e J i:
si	s I
silu	s I l u
sily	s I l I
situacich	s I t u a t_s I x
skatečné	s k a t e t_S n e:
skaženej	s k a Z e n e j
skejťak	s k e j c a k
sklacená	s k l a t_s e n a:
sklamaná	s k l a m a n a:
sklyzeň	s k l I z e J
skolu	s k o l u
skoly	s k o l I
skoncil	s k o n t_s I l
skontrolovat	s k o n t r o l o v a t
skopní	s k o p J i:
skoró	s k o r o:
skouzky	s k o_u z k I
skoužký	s k o_u Z k i:
skupinach	s k u p I n a x
skutečni	s k u t e t_S J I
skutečny	s k u t e t_S n I
skušenost	s k u S e n o s t
skvelé	s k v e l e:
slabinámi	s l a b I n a: m I
sleduji	s l e d u j I
sliším	s l I S i: m
slnce	s l= n t_s e
slovensku	s l o v e n s k u
slunečko	s l u n e t_S k o
slunečými	s l u n e t_S i: m I
sluněčno	s l u J e t_S n o
sluněčné	s l u J e t_S n e:
sluněčný	s l u J e t_S n i:
sluzební	s l u z e b J i:
sluši	s l u S I
slušne	s l u S n e
slušnymi	s l u S n I m I
slyšel	s l I S e l
slyšime	s l I S I m e
slíšet	s l i: S e t
slůnce	s l u: n t_s e
slůnečno	s l u: n e t_S n o
sme	s m e
smutna	s m u t n a
smůtkem	s m u: t k e m
snadny	s n a d n I
snatně	s n a t J e
snaži	s n a Z I
snažime	s n a Z I m e
snidaní	s J I d a J i:
snidanía	s J I d a J i: a
snážili	s n a: Z I l I
snážit	s n a: Z I t
snáží	s n a: Z i:
snážím	s n a: Z i: m
sních	s J i: x
sobou	s o b o_u
sobé	s o b e:
socialní	s o t_s I a l J i:
socialním	s o t_s I a l J i: m
socialný	s o t_s I a l n i:
sou	s o_u
souhlasi	s o_u h\ l a s I
souhlasim	s o_u h\ l a s I m
soukromi	s o_u k r o m I
sousede	s o_u s e d e
současne	s o_u t_S a s n e
součastnem	s o_u t_S a s t n e m
součastnou	s o_u t_S a s t n o_u
součastných	s o_u t_S a s t n i: x
součásně	s o_u t_S a: s J e
spatký	s p a t k i:
specialní	s p e t_s I a l J i:
specificke	s p e t_s I f I t_s k e
spi	s p I
spiš	s p I S
spoRtovni	s p o r t o v J I
spokojeny	s p o k o j e n I
spokojná	s p o k o j n a:
spolecnost	s p o l e t_s n o s t
společenskich	s p o l e t_S e n s k I x
spoločenských	s p o l o t_S e n s k i: x
spolupraci	s p o l u p r a t_s I
spolužak	s p o l u Z a k
spolů	s p o l u:
spolůžáky	s p o l u: Z a: k I
sportověc	s p o r t o v j e t_s
spoustů	s p o_u s t u:
spracovat	s p r a t_s o v a t
spracování	s p r a t_s o v a: J i:
spravne	s p r a v n e
spravnej	s p r a v n e j
spravnemu	s p r a v n e m u
spravně	s p r a v J e
spravědlivý	s p r a v j e d l I v i:
správne	s p r a: v n e
správy	s p r a: v I
spusob	s p u s o p
spátné	s p a: t n e:
spůsobem	s p u: s o b e m
spůsobu	s p u: s o b u
srdčeny	s r= d t_S e n I
sredu	s r e d u
sstiskat	s c I s k a t
stRedni	s t r e d J I
stale	s t a l e
stara	s t a r a
stat	s t a t
statní	s t a t J i:
stava	s t a v a
stavalo	s t a v a l o
stači	s t a t_S I
staře	s t a P\ e
staři	s t a P\ I
stejne	s t e j n e
stejnemokamžiku	s t e j n e m o k a m Z I k u
stejny	s t e j n I
stoji	s t o j I
stoleti	s t o l e c I
stoupa	s t o_u p a
stradají	s t r a d a j i:
stradání	s t r a d a: J i:
stranku	s t r a N k u
stranky	s t r a N k I
stravil	s t r a v I l
stravila	s t r a v I l a
stravovaní	s t r a v o v a J i:
stredu	s t r e d u
stryce	s t r I t_s e
strách	s t r a: x
strácí	s t r a: t_s i:
strány	s t r a: n I
strátil	s t r a: c I l
strátit	s t r a: c I t
studiům	s t u J\ I u: m
studovála	s t u d o v a: l a
studovát	s t u d o v a: t
stupnem	s t u p n e m
stál	s t a: l
stálo	s t a: l o
stáre	s t a: r e
stárá	s t a: r a:
stástný	s t a: s t n i:
stáva	s t a: v a
stískálo	s c i: s k a: l o
stěhovaní	s c e h\ o v a J i:
stěsti	s c e s c I
středísku	s t Q\ e J\ i: s k u
svami	s v a m I
svatbe	s v a t b e
svatek	s v a t e k
svateční	s v a t e t_S J i:
sve	s v e
sveho	s v e h\ o
svem	s v e m
svemu	s v e m u
svemživote	s v e m Z I v o t e
svetlé	s v e t l e:
svetí	s v e c i:
svich	s v I x
svimi	s v I m I
svlekne	s v l e k n e
svuj	s v u j
svy	s v I
svéch	s v e: x
svéte	s v e: t e
svědom	s v j e d o m
svědomi	s v j e d o m I
svěm	s v j e m
světe	s v j e t e
světove	s v j e t o v e
sympatecká	s I m p a t e t_s k a:
sámi	s a: m I
séznamili	s e: z n a m I l I
sézona	s e: z o n a
sézony	s e: z o n I
sí	s i:
síce	s i: t_s e
sýna	s i: n a
sčastnou	s t_S a s t n o_u
sčastná	s t_S a s t n a:
sťastné	s c a s t n e:
sťastného	s c a s t n e: h\ o
sťastný	s c a s t n i:
t.d.	t d
tak	t a k
take	t a k e
takegraí	t a k e g r a i:
taki	t a k I
takova	t a k o v a
takove	t a k o v e
takovy	t a k o v I
takí	t a k i:
taký	t a k i:
takě	t a k j e
tata	t a t a
tatinek	t a c I n e k
tatinka	t a c I N k a
tatra	t a t r a
taňcili	t a J t_s I l I
te	t e
tebe	t e b e
tebou	t e b o_u
tebě	t e b j e
tech	t e x
technologíckí	t e x n o l o g i: t_s k i:
ted	t e t
temata	t e m a t a
tematou	t e m a t o_u
teměř	t e m J e Q\
teniskach	t e J I s k a x
teple	t e p l e
tepleho	t e p l e h\ o
teprvé	t e p r= v e:
teto	t e t o
texnický	t e J I t_s k i:
teší	t e S i:
teším	t e S i: m
težke	t e Z k e
težké	t e Z k e:
ti	c I
tim	c I m
timech	c I m e x
tisic	c I s I t_s
tmávou	t m a: v o_u
to	t o
tolikrat	t o l I k r a t
tolík	t o l i: k
tom	t o m
tomů	t o m u:
tradici	t r a J\ I t_s I
trapí	t r a p i:
travim	t r a v I m
travit	t r a v I t
traví	t r a v i:
travím	t r a v i: m
treba	t r e b a
trenovat	t r e n o v a t
tricet	t r I t_s e t
trosku	t r o s k u
trpve	t r= p v e
tríčko	t r i: t_S k o
trěba	t r j e b a
turisty	t u r I s t I
tva	t v a
tvař	t v a Q\
tve	t v e
tveho	t v e h\ o
tvoj	t v o j
tvoje	t v o j e
tvojé	t v o j e:
tvou	t v o_u
tvrdít	t v r= d i: t
tvrženi	t v r= Z e J I
tvuj	t v u j
tvuje	t v u j e
tvurcem	t v u r t_s e m
tvého	t v e: h\ o
tvůj	t v u: j
tyden	t I d e n
tydny	t I d n I
tydný	t I d n i:
tym	t I m
tympádem	t I m p a: d e m
tymy	t I m I
tymů	t I m u:
typi	t I p I
tá	t a:
ták	t a: k
táke	t a: k e
tákovým	t a: k o v i: m
táky	t a: k I
tám	t a: m
táto	t a: t o
tén	t e: n
tí	c i:
tým	t i: m
týmizkoušami	t i: m I z k o_u S a m I
tě	c e
těbe	c e b e
těple	c e p l e
těsil	c e s I l
tězký	c e z k i:
těď	c e c
těšim	c e S I m
těšky	c e S k I
těžke	c e Z k e
těžky	c e Z k I
třid	t Q\ I t
třičku	t Q\ I t_S k u
uctou	u t_s t o_u
ucí	u t_s i:
ucít	u t_s i: t
udalost	u d a l o s t
udalosti	u d a l o s c I
udela	u d e l a
udelalo	u d e l a l o
udelat	u d e l a t
udeláme	u d e l a: m e
udelát	u d e l a: t
uděla	u J\ e l a
udělali	u J\ e l a l I
udělalí	u J\ e l a l i:
udělaš	u J\ e l a S
udělála	u J\ e l a: l a
ujištuji	u j I S t u j I
ukazala	u k a z a l a
ukazát	u k a z a: t
umožnena	u m o Z n e n a
unaveny	u n a v e n I
unavěný	u n a v j e n i:
universalií	u J I v e r s a l I i:
univerzalní	u J I v e r z a l J i:
univerzite	u J I v e r z I t e
uplně	u p l= n j e
uprednostňují	u p r e d n o s t J u j i:
uraz	u r a s
urcit	u r t_s I t
urovni	u r o v J I
urovně	u r o v J e
určene	u r t_S e n e
určite	u r t_S I t e
určity	u r t_S I t I
uršité	u r S I t e:
usilí	u s I l i:
uslýšet	u s l i: S e t
usměv	u s m J e f
uspech	u s p e x
uspěchu	u s p j e x u
uspěchů	u s p j e x u:
uspěšný	u s p j e S n i:
uspěšně	u s p j e S J e
usíli	u s i: l I
utratite	u t r a c I t e
uvaři	u v a P\ I
uvažiz	u v a Z I s
uvidim	u v I J\ I m
uvidime	u v I J\ I m e
uvidiš	u v I J\ I S
uvidímě	u v I J\ i: m J e
uvídíme	u v i: J\ i: m e
uz	u s
uzký	u z k i:
uzna	u z n a
uznávam	u z n a: v a m
učastniků	u t_S a s t J I k u:
učastnit	u t_S a s t J I t
učebných	u t_S e b n i: x
učes	u t_S e s
uči	u t_S I
učim	u t_S I m
učime	u t_S I m e
učitele	u t_S I t e l e
učitelu	u t_S I t e l u
učít	u t_S i: t
užitečni	u Z I t e t_S J I
uživaji	u Z I v a j I
uživáji	u Z I v a: j I
v	v
vam	v a m
vami	v a m I
vamy	v a m I
vamí	v a m i:
vas	v a s
vazný	v a z n i:
vašém	v a S e: m
važnou	v a Z n o_u
važně	v a Z J e
važít	v a Z i: t
vdělaní	v J\ e l a J i:
ve	v e
vec	v e t_s
veceř	v e t_s e Q\
veceří	v e t_s e P\ i:
veci	v e t_s I
vedet	v e d e t
veděcký	v e J\ e t_s k i:
velka	v e l k a
velkem	v e l k e m
velky	v e l k I
velme	v e l m e
velmy	v e l m I
velmí	v e l m i:
velní	v e l J i:
vernější	v e r J e j S i:
vesely	v e s e l I
vetsina	v e t s I n a
vetši	v e t S I
vetšinou	v e t S I n o_u
vetší	v e t S i:
večeri	v e t_S e r I
večeří	v e t_S e P\ i:
vi	v I
vic	v I t_s
vice	v I t_s e
vicse	v I t_s s e
videla	v I d e l a
videt	v I d e t
vidim	v I J\ I m
viecí	v I e t_s i:
vikend	v I k e n t
vikendu	v I k e n d u
vim	v I m
vime	v I m e
virtualní	v I r t u a l J i:
viry	v I r I
vitř	v I t Q\
viš	v I S
vkonkretní	v k o N k r e t J i:
vlada	v l a d a
vlastné	v l a s t n e:
vlastnícho	v l a s t J i: x o
vodá	v o d a:
vola	v o l a
volny	v o l n I
voňovéj	v o J o v e: j
vpodstátě	v p o d s t a: c e
vpořádku	v p o P\ a: d k u
vraceji	v r a t_s e j I
vracim	v r a t_s I m
vrati	v r a c I
vratim	v r a c I m
vratit	v r a c I t
vratí	v r a c i:
vratím	v r a c i: m
vratíme	v r a c i: m e
vrácim	v r a: t_s I m
vsechno	v s e x n o
vsechny	v s e x n I
vsichni	v s I x J I
vspomenem	v s p o m e n e m
vspomenu	v s p o m e n u
vspomínát	v s p o m i: n a: t
vstahy	v s t a h\ I
vstaváme	v s t a v a: m e
vstazich	v s t a z I x
vstávát	v s t a: v a: t
vstřicnymí	v s t Q\ I t_s n I m i:
vsym	v s I m
vulgarné	v u l g a r n e:
vybavění	v I b a v j e J i:
vybirat	v I b I r a t
vyborne	v I b o r n e
vyborné	v I b o r n e:
vyborný	v I b o r n i:
vyborně	v I b o r J e
vybávení	v I b a: v e J i:
vybíráji	v I b i: r a: j I
vyběr	v I b j e r
vychodní	v I x o d J i:
vychova	v I x o v a
vychovately	v I x o v a t e l I
vychovy	v I x o v I
vychóvav	v I x o: v a f
vydelavají	v I d e l a v a j i:
vydělavat	v I J\ e l a v a t
vyhled	v I h\ l e t
vyhledem	v I h\ l e d e m
vyhodu	v I h\ o d u
vyhody	v I h\ o d I
vyjadřil	v I j a d P\ I l
vyjimky	v I j I m k I
vyjletě	v I j l e c e
vyjádřovat	v I j a: d P\ o v a t
vylet	v I l e t
vyleta	v I l e t a
vyleti	v I l e c I
vyletu	v I l e t u
vylety	v I l e t I
vylečit	v I l e t_S I t
vylist	v I l I s t
vylét	v I l e: t
vymyslite	v I m I s l I t e
vymýslet	v I m i: s l e t
vypada	v I p a d a
vypádají	v I p a: d a j i:
vypádá	v I p a: d a:
vyrazný	v I r a z n i:
vysledek	v I s l e d e k
vysoka	v I s o k a
vysoke	v I s o k e
vysokotechnonogicky	v I s o k o t e x n o n o g I t_s k I
vysova	v I s o v a
vystavě	v I s t a v j e
vytvořilí	v I t v o P\ I l i:
vytěžiť	v I c e Z I c
vyuku	v I u k u
využitim	v I u Z I c I m
využíti	v I u Z i: c I
využítí	v I u Z i: c i:
vyvijen	v I v I j e n
vyvijet	v I v I j e t
vyvoj	v I v o j
vyznam	v I z n a m
vyznám	v I z n a: m
vyúčení	v I u: t_S e J i:
vyřešil	v I P\ e S I l
vyřešít	v I P\ e S i: t
vyše	v I S e
vzacného	v z a t_s n e: h\ o
vzbudít	v z b u J\ i: t
vzdelaní	v z d e l a J i:
vzdelavej	v z d e l a v e j
vzdelání	v z d e l a: J i:
vzdelánými	v z d e l a: n i: m I
vzdělani	v z J\ e l a J I
vzdělaní	v z J\ e l a J i:
vzdělaními	v z J\ e l a J i: m I
vzdělavací	v z J\ e l a v a t_s i:
vzdělavaní	v z J\ e l a v a J i:
vzděláni	v z J\ e l a: J I
vzděláným	v z J\ e l a: n i: m
vzdělávaní	v z J\ e l a: v a J i:
vzit	v z I t
vzpominam	v z p o m I n a m
vzpominat	v z p o m I n a t
vzpominky	v z p o m I N k I
vzpomínam	v z p o m i: n a m
vánocích	v a: n o t_s i: x
vášemu	v a: S e m u
vášého	v a: S e: h\ o
vélka	v e: l k a
vélkou	v e: l k o_u
vídam	v i: d a m
vídí	v i: J\ i:
vídím	v i: J\ i: m
vídíme	v i: J\ i: m e
víděli	v i: J\ e l I
vídět	v i: J\ e t
vílet	v i: l e t
vý	v i:
výborne	v i: b o r n e
výbrat	v i: b r a t
výbratto	v i: b r a t o
východ	v i: x o t
výhlet	v i: h\ l e t
výjde-li	v i: j d e l I
výpadad	v i: p a d a t
výpadají	v i: p a d a j i:
výpadá	v i: p a d a:
výpadáme	v i: p a d a: m e
výsokáškola	v i: s o k a: S k o l a
vývolává	v i: v o l a: v a:
výž	v i: S
včecho	v t_S e x o
věci	v j e t_s I
věcipotřebujeme	v j e t_s I p o t Q\ e b u j e m e
věcy	v j e t_s I
věcí	v j e t_s i:
vědeli	v j e d e l I
vědet	v j e d e t
věrím	v j e r i: m
věsnici	v j e s J I t_s I
věčšinou	v j e t_S S I n o_u
všechní	v S e x J i:
všecho	v S e x o
všechy	v S e x I
všechí	v S e x i:
všehno	v S e h\ n o
všekno	v S e k n o
všichny	v S I x n I
všichní	v S I x J i:
všimám	v S I m a: m
všychno	v S I x n o
všychny	v S I x n I
všéchno	v S e: x n o
všíchni	v S i: x J I
všímne	v S i: m n e
vždicky	v Z J\ I t_s k I
vždický	v Z J\ I t_s k i:
vždycký	v Z d I t_s k i:
vẙčítkami	v t_S i: t k a m I
y	I
za	z a
zabavu	z a b a v u
zabit	z a b I t
zabyvají	z a b I v a j i:
zachazení	z a x a z e J i:
zachranila	z a x r a J I l a
zachýcená	z a x i: t_s e n a:
zacina	z a t_s I n a
zadnich	z a d J I x
zadny	z a d n I
zadů	z a d u:
zahraniči	z a h\ r a J I t_S I
zahranící	z a h\ r a J i: t_s i:
zaimavých	z a I m a v i: x
zajem	z a j e m
zajima	z a j I m a
zajimave	z a j I m a v e
zajimaveho	z a j I m a v e h\ o
zajimavou	z a j I m a v o_u
zajimavy	z a j I m a v I
zajimavé	z a j I m a v e:
zajimavý	z a j I m a v i:
zajimavých	z a j I m a v i: x
zajimavými	z a j I m a v i: m I
zajimavě	z a j I m a v j e
zajimovy	z a j I m o v I
zajimové	z a j I m o v e:
zajmava	z a j m a v a
zajmavu	z a j m a v u
zajmavá	z a j m a v a:
zajímave	z a j i: m a v e
zajímavy	z a j i: m a v I
zajímavymí	z a j i: m a v I m i:
zajímavý	z a j i: m a v i:
zajímavě	z a j i: m a v j e
zajíšťuje	z a j i: S c u j e
zaklad	z a k l a t
zaklade	z a k l a d e
zakladní	z a k l a d J i:
zaklady	z a k l a d I
zakladům	z a k l a d u: m
zakládní	z a k l a: d J i:
zakázníky	z a k a: z J i: k I
zalečítosti	z a l e t_S i: t o s c I
zaleži	z a l e Z I
zaležitostí	z a l e Z I t o s c i:
zaleží	z a l e Z i:
zaležína	z a l e Z i: n a
zamestnanci	z a m e s t n a n t_s I
zamestnaní	z a m e s t n a J i:
zamestnaních	z a m e s t n a J i: x
zamilovany	z a m I l o v a n I
zamyšlet	z a m I S l e t
zamýslet	z a m i: s l e t
zaměstnaní	z a m J e s t n a J i:
zaměstnánci	z a m J e s t n a: n t_s I
zapaltít	z a p a l c i: t
zaplatim	z a p l a c I m
zapoměl	z a p o m J e l
zapoměla	z a p o m J e l a
zapoměli	z a p o m J e l I
zaptat	z a p t a t
zarezervovát	z a r e z e r v o v a: t
zaslaní	z a s l a J i:
zaspominame	z a s p o m I n a m e
zastancem	z a s t a n t_s e m
zastavka	z a s t a v k a
zasílani	z a s i: l a J I
zatašeno	z a t a S e n o
zatim	z a c I m
zatimco	z a c I m t_s o
zavesila	z a v e s I l a
zavidět	z a v I J\ e t
zavolát	z a v o l a: t
zavěr	z a v j e r
zavěru	z a v j e r u
zavřeny	z a v P\ e n I
začat	z a t_S a t
začatek	z a t_S a t e k
začatku	z a t_S a t k u
začina	z a t_S I n a
začinaji	z a t_S I n a j I
začinají	z a t_S I n a j i:
začinající	z a t_S I n a j i: t_s i:
začinaly	z a t_S I n a l I
začinam	z a t_S I n a m
začinat	z a t_S I n a t
začiná	z a t_S I n a:
začináme	z a t_S I n a: m e
začit	z a t_S I t
začnéme	z a t_S n e: m e
začína	z a t_S i: n a
zaři	z a P\ I
zaří	z a P\ i:
zaštita	z a S c I t a
zažitek	z a Z I t e k
zbýtečně	z b i: t e t_S J e
zda	z d a
zdelovaci	z d e l o v a t_s I
zdrava	z d r a v a
zdrávi	z d r a: v I
zdůrázňuje	z d u: r a: z J u j e
ze	z e
zejnena	z e j n e n a
zemí	z e m i:
zemý	z e m i:
zena	z e n a
zeptát	z e p t a: t
zidli	z I d l I
zijí	z I j i:
ziskat	z I s k a t
ziskává	z I s k a: v a:
zitra	z I t r a
zivot	z I v o t
zivota	z I v o t a
zivotní	z I v o t J i:
zivotě	z I v o c e
zjístila	z j i: s c I l a
zjístit	z j i: s c I t
zjístí	z j i: s c i:
zklámali	z k l a: m a l I
zkoumaní	z k o_u m a J i:
zkousky	z k o_u s k I
zkouček	z k o_u t_S e k
zkoušim	z k o_u S I m
zkošenost	z k o S e n o s t
zkošenostmi	z k o S e n o s t m I
zkúšenostím	z k u: S e n o s c i: m
zlamek	z l a m e k
zlate	z l a t e
zmněnila	z m= n j e J I l a
zmylít	z m I l i: t
zna	z n a
znalostí	z n a l o s c i:
zname	z n a m e
znamena	z n a m e n a
znamy	z n a m I
znamá	z n a m a:
znaména	z n a m e: n a
znaměna	z n a m J e n a
znači	z n a t_S I
znaš	z n a S
znála	z n a: l a
ználosti	z n a: l o s c I
ználostmi	z n a: l o s t m I
ználostí	z n a: l o s c i:
známeho	z n a: m e h\ o
známena	z n a: m e n a
známená	z n a: m e n a:
známych	z n a: m I x
zobrázena	z o b r a: z e n a
zpravy_Spolu	z p r a v I s p o l u
ztotožnena	z t o t o Z n e n a
ztratít	z t r a c i: t
ztrátit	z t r a: c I t
zustala	z u s t a l a
zustanou	z u s t a n o_u
zustat	z u s t a t
zučastnit	z u t_S a s t J I t
zvikl	z v I k l=
zviknout	z v I k n o_u t
zviřa	z v I P\ a
zviřata	z v I P\ a t a
zviřát	z v I P\ a: t
zviřátka	z v I P\ a: t k a
zvladat	z v l a d a t
zvladne	z v l a d n e
zvladneme	z v l a d n e m e
zvlaštně	z v l a S t J e
zvyditelnit	z v I J\ I t e l J I t
zvykla	z v I k l a
zvyšenou	z v I S e n o_u
zvíknu	z v i: k n u
zvýknout	z v i: k n o_u t
zá	z a:
zádat	z a: d a t
základe	z a: k l a d e
základný	z a: k l a d n i:
základí	z a: k l a J\ i:
záležítosti	z a: l e Z i: t o s c I
záse	z a: s e
záveř	z a: v e Q\
záčatku	z a: t_S a t k u
zíma	z i: m a
získ	z i: s k
získam	z i: s k a m
získana	z i: s k a n a
získaní	z i: s k a J i:
získavání	z i: s k a v a: J i:
získu	z i: s k u
zít	z i: t
zívot	z i: v o t
zívotě	z i: v o c e
zě	z j e
zůstavají	z u: s t a v a j i:
zůstavala	z u: s t a v a l a
zůstavám	z u: s t a v a: m
zůčastnit	z u: t_S a s t J I t
zůčastnít	z u: t_S a s t J i: t
á	a:
árí	a: r i:
étiku	e: c I k u
úmět	u: m J e t
úrovní	u: r o v J i:
úrčité	u: r t_S I t e:
úrčitě	u: r t_S I c e
úspechy	u: s p e x I
účení	u: t_S e J i:
účit	u: t_S I t
ČLOVEKU	t_S l o v e k u
Čechach	t_S e x a x
Černe	t_S e r n e
Černem	t_S e r n e m
Česka	t_S e s k a
Česke	t_S e s k e
Češim	t_S e S I m
Češtinu	t_S e S c I n u
Češtiny	t_S e S c I n I
Čhtela	t_S h\ t e l a
Čož	t_S o S
Částo	t_S a: s t o
čas	t_S a s
čast	t_S a s t
časte	t_S a s t e
časteje	t_S a s t e j e
časti	t_S a s c I
často	t_S a s t o
častějí	t_S a s c e j i:
čekát	t_S e k a: t
čelý	t_S e l i:
černe	t_S e r n e
černy	t_S e r n I
čerstvem	t_S e r s t v e m
čestinu	t_S e s c I n u
čestiny	t_S e s c I n I
čestovat	t_S e s t o v a t
češtiný	t_S e S c I n i:
čhtela	t_S h\ t e l a
čim	t_S I m
čist	t_S I s t
človek	t_S l o v e k
človeka	t_S l o v e k a
človeke	t_S l o v e k e
človekem	t_S l o v e k e m
človeku	t_S l o v e k u
človék	t_S l o v e: k
člověk	t_S l o v j e k
člověkoví	t_S l o v j e k o v i:
člověkú	t_S l o v j e k u:
čtýři	t_S t i: P\ I
čás	t_S a: s
čásť	t_S a: s c
Ďražďan	J\ r a Z J\ a n
ďiťemusí	J\ I c e m u s i:
ňičí	J I t_S i:
Řikaji	I k a j I
Řikají	I k a j i:
Řime	I m e
řase	P\ a s e
řeči	P\ e t_S I
řict	P\ I t_s t
řicí	P\ I t_s i:
řidický	P\ I J\ I t_s k i:
řika	P\ I k a
řikaji	P\ I k a j I
řikají	P\ I k a j i:
řikal	P\ I k a l
řikat	P\ I k a t
řiká	P\ I k a:
řikát	P\ I k a: t
řikáš	P\ I k a: S
říka	P\ i: k a
říkalá	P\ i: k a l a:
říkame	P\ i: k a m e
říkavali	P\ i: k a v a l I
říkaš	P\ i: k a S
řísky	P\ i: s k I
ŠaRke	S a r k e
Šedi	S e J\ I
Špaňelsku	S p a J e l s k u
šatach	S a t a x
šatniků	S a t J I k u:
šef	S e f
šesta	S e s t a
škala	S k a l a
škkolý	S k o l i:
školach	S k o l a x
školi	S k o l I
školskeho	S k o l s k e h\ o
školstvi	S k o l s t v I
školě	S k o l j e
špatne	S p a t n e
špátně	S p a: t J e
špínavém	S p i: n a v e: m
štastna	S t a s t n a
štastnej	S t a s t n e j
štesti	S t e s c I
štešně	S t e S J e
štjastén	S t j a s t e: n
štreda	S t r e d a
štredu	S t r e d u
štěsti	S c e s c I
štěsťi	S c e s c I
šáty	S a: t I
šťasny	S c a s n I
šťastna	S c a s t n a
šťastny	S c a s t n I
šťasťe	S c a s c e
šťestí	S c e s c i:
ůcít	u: t_s i: t
ůkol	u: k o l
ůspěch	u: s p j e x
źe	e
źivot	I v o t
Žací	Z a t_s i:
Žadnou	Z a d n o_u
Žeby	Z e b I
žabkach	Z a b k a x
žaci	Z a t_s I
žadal	Z a d a l
žadneho	Z a d n e h\ o
žadnou	Z a d n o_u
žadné	Z a d n e:
žadného	Z a d n e: h\ o
žadný	Z a d n i:
žadost	Z a d o s t
žaka	Z a k a
žakladní	Z a k l a d J i:
žaky	Z a k I
žaků	Z a k u:
že	Z e
ženske	Z e n s k e
žit	Z I t
živote	Z I v o t e
životni	Z I v o t J I
životnim	Z I v o t J I m
životnimi	Z I v o t J I m I
životný	Z I v o t n i:
životá	Z I v o t a:
životém	Z I v o t e: m
žkoušku	Z k o_u S k u
žkoušky	Z k o_u S k I
žkušenost	Z k u S e n o s t
žádny	Z a: d n I
žílo	Z i: l o
žívota	Z i: v o t a
žívotu	Z i: v o t u
žívotě	Z i: v o c e
Ṡvýcarska	v i: t_s a r s k a
