2 1/2	
qm. größe	
(	
)	
,	
-	
.	
/	
10	
2	
20Ten	t @ n
22Ten	t @ n
2Zimmer	ts I m 6
3	
3-Zimmer	ts I m 6
31/2	
3Zimmer	ts I m 6
4	
4-Zimmer	ts I m 6
41/2	
ALLes	? a l @ s
AU-Pair-Agentur	? aU p aI 6 ? a g E n t u:6
Aauch	? a: aU x
Abends	? a: b @ n t s
Aber	? a: b 6
Abschliessend	? a p S l i: s @ n t
Abschluss	? a p S l U s
Abschluß	? a p S l U s
Abschlußarbeit	? a p S l u s ? a r b aI t
Addresse	? a t d r E s @
Adresse	? a d r E s @
Afzug	? a f ts u: k
Agentur	? a g E n t u:6
Agust	? a g U s t
Aingang	? aI n g a N
Alesclar	? a l E S l a r
Alle	? a l @
Alles	? a l @ s
Als	? a l s
Alt	? a l t
Altag	? a l t a: k
Altere	? a l t @ r @
Am	? a m
Amt	? a m t
AnZeige	? a n ts aI g @
Anannse	? a n a n z @
Anderen	? a n d @ r @ n
Andereseits	? a n d @ r e z aI t s
Anderseites	? a n d 6 z aI t @ s
Anderseits	? a n d @ r z aI t s
Anfand	? a n f a n t
Angebot	? a n g @ b o: t
Anlaß	? a n l a s
Anlegenheit	? a n l e: g @ n h aI t
Anrufen	? a n r u: f @ n
Anschlißlich	? a n S l I s l I C
Ansonst	? a n z O n s t
Antword	? a n t v 96 t s
Antwortest	? a n t v 96 t @ l s t
Antwortet	? a n t v O6 t @ t
Anworten	? a n v 96 t @ n t
Anziege	? a n ts i: g @
Anzige	? a n ts I g @
Aotu	? a ? o: E U
Arbait	? a r b aI t
Arbeistelle	? a r b aI S t E l @
Arbeit	? a r b aI t
Arbeite	? a r b aI t @
Arbeiten	? a r b aI t @ n
Arbeitet	? a r b aI t @ t
Arbeits	? a r b aI t s
Arbeitsam	? a r b aI t s a m
Arbeitskolegen	? a r b aI t s k o l e: g @ n
Arbeitsplazt	? a r b aI t s p l a ts t
Arbeitstele	? a r b aI t s t e: l @
Arbet	? a r b @ t
Arm	? a r m
Armenischen	? a r m e: n I S @ n
Artz	? a r t s
Arzt	? a r ts t
Astahnd	? a s t a: n t
Atworten	? a t v 96 t @ n t
Atwortes	? a t v 96 t @ l s
Au	? aU
Au-Pair	? aU p aI 6
Au-PairGlobal	? aU p aI r g l o b a: l
Au-Pairglobal	? aU p aI r g l o b a: l
Au-pair	? aU p aI 6
Au-pair-Argentur	? aU p aI 6 ? a r g @ n t u:6 6
Au-pair-mädchen	? aU p aI 6 m E: t C @ n
Au-pair-mädschen	? aU p aI 6 m E t s C @ n
Au-pairsgloball	? aU p aI r s g l o b a l
AuWiedehören	? aU v i: d @ h 2: r @ n
Aufenterlaunbis	? aU f @ n t 6 l aU n b I s
Aufenthalts	? aU f ? E n t h a l t s
Aufenthaltsformalitaten	? aU f ? E n t h a l t s f O r m a: l i t a: t @ n
Aufenthatsformalitäten	? aU f ? E n t a t s f O r m a l i t E: t @ n
Aufwiederhören	? aU f v i: d 6 h 2: r @ n
Aupair-sglobal	? aU p aI 6 s g l o b a: l
Ausbildung	? aU s b I l d U N
Auser	? aU s 6
Auserdem	? aU s 6 d e: m
Auslad	? aU s l a: t
Auslander	? aU s l a n d 6
Auslandren	? aU s l a n d r @ n
Ausserdem	? aU s 6 d e: m
Ausserhalb	? aU s 6 h a l p
Auswalh	? aU s v a l
Auswart	? aU s v a r t
Azten	? a ts t @ n
B2	b e:
Babby	b E b i
Babezimmer	b a b @ ts I m 6
Babysiter	b e: b i z I t 6
Bade	b a: d @
Bahnhof	b a: n h o: f
Bald	b a l t
Baldige	b a l d I g @
Baled	b a: l E t
BanHof	b a n h o: f
Bandern	b a n d 6 n
Banhhof	b a n h o: f
Banhof	b a n h o: f
Basilica	b a z i l i k a
Beacten	b @ ? a k t @ n
Bebi	b @ b i
Beby	b @ b i
Bebys	b @ b i s
Becker	b E k 6
Begrundung	b @ g r U n d U N
Bekanten	b @ k a n t @ n
Bekommen	b @ k O m @ n
Benuzen	b @ n U ts @ n
Bereicht	b @ r aI C t
Bereit	b @ r aI t
Berif	b @ r i: f
Beruf	b @ r u: f
Berufsriechtung	b @ r u: f s r i: C t U N
Berufstätig	b @ r u: f s t E: t I C
Berufstättig	b @ r u: f S t E t I C
Bescheinigum	b @ S aI n i g U m
Beschriebenen	b @ S r i: b @ n @ n
Beschwere	b @ S v e: r @
Besichtgungstermin	b @ z I C t g U N s t 6 m i: n
Besichtingungstermin	b @ z I C t I N U N s t 6 m i: n
Besoche	b @ z O x @
Besonder	b @ z O n d 6
Bespracht	b @ S p r a: x t
Besser	b E s 6
Beste	b E s t @
Besuche	b @ z u: x @
Besuchen	b @ z u: x @ n
Beswerden	b @ s v 6 d @ n
Betreeung	b @ t r @ ? OY N
Betreeuung	b @ t r e: u: U N
Betref	b @ t r E f
Betreffziele	b @ t r E f ts i: l @
Betreung	b @ t r OY N
Betrib	b @ t r I p
Betriebswirtschaftslehrin	b @ t r i: p s v i: r t S a f t s l e: r I n
Betriff	b @ t r I f
Bevolkerung	b @ f O l k @ r U N
Bewerben	b @ v E6 b @ n
Bewerber	b @ v E6 b 6
Bewerbungsgesprech	b @ v 6 b U N s g @ S p r E C
Bewöhner	b @ v 2: n 6
Bezahlt	b @ z a: l t
Bhan	b h a n
BiTTe	b I t @
Bickini	b I k i: n i
Bieref	b i: r E f
Bildet	b I l d @ t
Billig	b I l I C
BilligFlüge	b I l I C f l y: g @
Bir	b i r
Birele	b i r e l @
Birila	b i r i: l a
Birings	b i r I N s
Biro	b i r o
Bis	b I s
Bisen	b i: z @ n
Bisichtigungstermin	b I z I C t I g U N s t 6 m i: n
Bist	b I s t
Bitte	b I t @
Bitten	b I t @ n
Bitteschreiben	b I t @ S r aI b @ n
Blau	b l aU
Blaue	b l aU @
Bleiben	b l aI b @ n
Bohn	b o: n
Bolkon	b O l k O n
Bon	b O n
Breif	b r aI f
Brif	b r i: f
Bringen	b r I N @ n
Briv	b r i: f
Brotchen	b r O t C @ n
Brüfung	b r y: f U N
Buch	b u: x
Bucher	b u: x 6
Bureau	b u: r o:
Bus	b U s
BusFahrkarte	b U s f a: r k a r t @
Bushaltestele	b U s h a l t @ S t @ l @
Bädzimmer	b E t s I m 6
Bäümen	b E Y m @ n
Börcen	b 96 r s @ n
Centrum	ts E n t r U m
Certificat	s E6 t s i f i k a t
Chanse	C a: n z @
Cheff	S E f
Chemie	C e m i:
Chencen	C E n ts @ n
Ciriculum	s i r i k U l U m
Collegen	k O l e: g @ n
Computer	k O m p j u: t 6
Comupter	k o m U p t 6
Cus	k U s
DAS	d a s
DEUTSCHSLAND	d OY t S s l a n t
Da	d a
DachWohnung	d a x v o: n U N
Daine	d aI n @
Dak	d a k
Dammen	d a m @ n
DanK	d a N k
DanKe	d a N k @
Dancke	d a N k @
Daniiela	d a n i e: l a
Dankber	d a N k b 6
Danke	d a N k @
Dann	d a n
Darfen	d a r f @ n
Darum	d a r U m
Darüberhinaus	d a r y: b 6 h I n aU s
Das	d a s
Dass	d a s
Daswegen	d a: s v e: g @ n
Datenverabreitung	d a: t @ n v @ r a b r aI t U N
Datun	d a t U n
Deautschland	d @ ? aU t S l a n t
Deke	d e: k @
Demen	d e m @ n
Desto	d E s t o
Deushe	d OY s h @
Deustchland	d OY s t C l a n t
Deutsch	d OY t S
DeutschSprache	d OY t S S p r a: x @
Deutsche	d OY t S @
Deutschefamilie	d OY t S E f a m i: l j @
Deutschefirma	d OY t S e f i r m a
Deutschekinder	d OY t S @ k I n d 6
Deutscheland	d OY t S @ l a n t
Deutschen	d OY t S @ n
Deutscherkenntniss	d OY t S 6 k @ n t n I s
Deutscherkentnis	d OY t S 6 k @ n t n I s
Deutschesprache	d OY t S @ S p r a: x @
Deutschkenntniss	d OY t S k E n t n I s
Deutschkur	d OY t S k U6 s
Deutschkurz	d OY t S k U6 ts i:
Deutschsprache	d OY t S S p r a: x @
Deutsh	d OY t S
Deutshkurs	d OY t s k U6 s
Deutshland	d OY t s l a n t
Dialog	d i a l o: k
Die	d i:
Dies	d i: s
Diese	d i: z @
Diesem	d i: z @ m
Dimentionen	d i m E n ts j o: n @ n
Donerbröt	d O n 6 b r 2: t
Drausen	d r aU z @ n
Drei	d r aI
Drei_Zimmer	d r aI ts I m 6
Dreter	d r e: t 6
Driken	d r aI k @ n
Drindl	d r I n d l
Durch	d U6 C
Dutsch	d U t S
E	? e:
E-Meil	? e: m aI l
E-Moil	? e: m OY l
E-mail	? e: m e: l
EInfamilienhäuse	? aI n f a m i: l j @ n h OY z @
EM	? e: ? E m
Eben	? e b @ n
Eigene	? aI g @ n @
Eigenshaften	? aI g @ n s h a f t @ n
Ein	? aI n
Einbaukuche	? aI n b aU k u x @
Einerseite	? aI n 6 z aI t @
Eingentlisch	? aI n g @ n t l I S
Einige	? aI n I g @
Einkaufscentren	? aI n k aU f s ts E n t r @ n
Einkaufszenter	? aI n k aU f s ts E n t 6
Einladum	? aI n l a: d U m
Einladun	? aI n l a: d U n
Einsteig	? aI n S t aI k
Einwöhnern	? aI n v 2: n 6 n
Einzielpersonen	? aI n ts i: l p 6 z o: n @ n
Eletern	? e l e: t 6 n
Elter	? E l t 6
Elteren	? E l t @ r @ n
Eltren	? E l t r @ n
Email	? i: m e: l
Emigränten	? e m i g r E n t @ n
Enchädigung	? E n C E: d I g U N
Englisch	? E N l I S
Englische	? E N l I S @
Englischen	? E N l I S @ n
Englischkentnissen	? E N l I S k E n t n I s @ n
English	? I N l I S
Englishlernen	? E N l I s l 6 n @ n
Enkelinen	? E N k @ l i: n @ n
Enladung	? E n l a: d U N
Entschuldiegund	? E n t S U l d i: g U n t
Entschuldig	? E n t S U l d I C
Entschuldingung	? E n t S U l d I N U N
Entsädigung	? E n t z E: d I g U N
Entäuschung	? E n t OY S U N
Ereichbar	? e: r aI C b a: r
Erfarung	? E r f a: r U N
Erfarungen	? E r f a: r U N @ n
Erfolgreichen	? E r f O l k r aI C @ n
Ergebniss	? E6 E6 g e: p n I s
Erinnst	? e: r I n s t
Erkenntnisgewin	? E6 r k @ n t n I s g @ v I n
Erklärt	? E6 k l E:6 t
Erpharung	E6 b f a: r U N
Erste	? e:6 s t @
Erstesmal	? E r S t @ s m a: l
Erstmal	? e:6 s t m a: l
Ertgespräche	? E6 p t g @ S p r E: C @
Erwarsene	? E6 r v a: r z @ n @
Erweitet	? E6 r v aI t @ t
Erzhalt	? E6 t s h a l t
Es	? E s
Essen	? E s @ n
Essmoglichkeiten	? E s m O g l I C k aI t @ n
Etwas	? E t v a s
Europa	? OY r o: p a
Europäeische	? OY r o: p E: aI S @
Europäischen	? OY r o p E: I S @ n
Exel	? E k s @ l
FON	f O n
FRanKfurt	f r a N k f U6 t
Fachhoch-Schule	f a x h o: x S u: l @
Fachwisen	f a x v aI z @ n
Fahr	f a: r
FahrKarte	f a: r k a: r t @
Fahre	f a: r @
Fahren	f a: r @ n
Fahrkarte	f a: r k a: r t @
Fahrkate	f a: r k a t @
Famalie	f a m a: l j @
Famelien	f a m @ l j @ n
Famiele	f a m j E l @
Famielie	f a m i: l i:
Famielien	f a m i: l j @ n
Famile	f a m aI l @
Famili	f a m i: l i
Familia	f a m i: l j a
Familien	f a m i: l j @ n
Famille	f a m I l @
Famillien	f a m I l j @ n
Fammilie	f a m i: l j @
FarkarTe	f a r k a r t @
Farkarte	f a r k a r t @
Fata	f a: t a
Fater	f a: t 6
Februa	f e: b r u a
Februer	f e b r u E r
Feiren	f aI r @ n
Feirwerk	f aI r v 6 k
Ferien	f e:6 j @ n
Fernstem	f E6 n s s t @ m
Fertig	f E6 t I C
Fest	f E s t
Festes	f E s t @ s
Feuerwer	f OY 6 v 6
Filen	f i: l @ n
Fille	f I l @
Finger	f I N 6
Finland	f I n l a n t
Firma	f I6 m a
Firmen	f I6 m @ n
Fischer	f I S 6
Fischers	f I S 6 s
Fitness	f I t n @ s
Flache	f l a x @
Flexibel	f l E k s i: b @ l
Fliege	f l i: g @
Flugssung	f l u: k s z U N
Fohrkorte	f o: r k o:6 r t @
Folkmusik	f O l k m u z i: k
Fraen	f r a e: n
Fragen	f r a: g @ n
Fransözisch	f r a n s 2: z I S
Franzosich	f r a n ts O S I C
Franzosisch	f r a n ts o: z I S
Franzözich	f r a n ts 2: z I C
Frau	f r aU
Frauen	f r aU @ n
Frei	f r aI
Freie	f r aI @
Freind	f r aI n t
Freitag	f r aI t a: k
Freitags	f r aI t a: k s
Freizeit	f r aI ts aI t
Fremd	f r E m t
Fremde	f r E m d @
Frend	f r E n t
Frenndlichen	f r E n t l I C @ n
Freudin	f r OY d i: n
Freue	f r OY @
Freuen	f r OY @ n
Freundichen	f r OY n d I C @ n
Freundlich	f r OY n t l I C
Freundliche	f r OY n t l I C @
Freundlichen	f r OY n t l I C @ n
Freundlihe	f r OY n t l I d
Freundschafskreis	f r OY n t S a: f s k r aI s
Freut	f r OY t
Freutlich	f r OY t l I C
Frie	f r i:
Friest	f r i: s t
Frietag	f r i: t a: k
Froindlichen	f r o ? I n t l I C @ n
Froundliche	f r aU n t l I C @
Frue	f r y:
Frundlaich	f r U n t l aI C
Fränzosisch	f r E n ts o: z I S
Fröndlischen	f r 2: n d l I S @ n
Fröumich	f r 2: m I C
Früchtuk	f r y: C t u: k
Früh	f r y:
Frühlig	f r y: l I C
Frühstuck	f r y: s t U k
Früling	f r Y l I N
Fur	f U6 s
Fussball	f u: s b a l
Fögel	f 2: g @ l
Für	f y:6
GLÜCKWÜNSCH	g l Y k v Y n S
Ganze	g a n ts @
Gast	g a s t
Gaste	g a s t @
Gastelandes	g a s t @ l a n d @ s
Geburgstag	g e: b u:6 k g s t a: k
Geburstag	g @ b U6 s t a: k
Geburtag	g @ b U6 s t a: k
Geburtsag	g @ b u:6 t s ? E a: k
Geburtstag	g @ b u:6 t s t a: k
Gebustag	g @ b U s t a: k
Gebutstag	g @ b u: t s t a: k
Geehrte	g @ ? e:6 t @
Geehte	g e: t @
Geerhte	g @ n r t @
Gefülle	g @ f Y l @
Gehen	g e: @ n
Geherte	g e: ? i: r t @
General	g e n @ r a: l
Gerage	g @ r a: g @
Germanistic	g E r m a n I s t I k
Geschefts	g @ S E f t s
Geschenk	g @ S E N k
Geschwezter	g @ S v E ts t 6
Geschäft	g @ S E f t
Geschänk	g @ S E N k
Geseck	g @ z E k
Gesellsaft	g @ z E l z a f t
Geselschaft	g @ z E l S a f t
Geselschaftsregelungen	g @ z E l S a f t s r e: g @ l U N @ n
Gesenk	g @ z E N k
Geshefte	g @ s h E f t @
Gesprach	g @ S p r a: x
Gesprech	g @ S p r E C
Geste	g e: s t @
Gesund	g @ z U n t
Gesundheid	g @ z U n t h aI t
Gesunheit	g @ z U n h aI t
Gesätze	g @ z E t s @
Get	g E t
Getrenk	g @ t r @ n k
Gezundheit	g @ ts U n t h aI t
Gimnasium	g I m n a: z j U m
Gisundheit	g I z U n t h aI t
Gitarspielen	g i t ? a r S p i: l @ n
Globalization	g l o b a l i ts a ts j o: n
Gluck	g l U k
Gluckwunsch	g l U k v U n S
Gluckwunschkarte	g l U k v U n S k a r t @
Gluk	g l u k
Glück	g l Y k
Glücklich	g l Y k l I C
Glücklicher	g l Y k l I C 6
Glücknsche	g l Y k n S @
Glückwunch	g l Y k v U N
Glückwunschekarte	g l Y k v U n s C @ k a r t @
Glückwünsch	g l Y k v Y n S
GlückwünschezubabY	g l Y k v Y n S e: ts u: b e: b i
Glüglich	g l y: k l I C
Glük	g l y: k
Gold	g O l t
Gottest	g O t @ s t
Gradulieren	g r a d u: l i: r @ n
Grage	g r a: g @
Gramatik	g r a: m a t I k
Gratuliere	g r a t u l i: r @
Gratulierefür	g r a t u l i: r @ f y: r
Gratulieren	g r a t u l i: r @ n
Gresß	g r e: s
Grischland	g r I S l a n t
GroBe	g r o: b @
Groß	g r o: s
Große	g r o: s @
Großen	g r o: s @ n
Großer	g r o: s 6
Gruppen-aktivitäten	g r U p @ n ? a k t I v I t E: t @ n
Grus	g r u: s
Gruse	g r u: z @
Gruß	g r u: s
GrußKüch	g r u: s k Y C
Gruße	g r u: s @
Gränze	g r E n ts @
Gröse	g r 2: z @
Grösser	g r 2: s 6
Größ	g r 2: s
Größe	g r 2: s @
Grüeße	g r y: @ s @
Grüse	g r y: z @
Grüsen	g r y: z @ n
Grüsse	g r Y s @
Grüssen	g r Y s @ n
Grüze	g r Y ts @
Grüß	g r y: s
GrüßeMaria	g r y: s @ m a: r i: a
Gug	g u: k
Guitarre	g u i t a r @
Gumnasium	g U m n a: z j U m
Gut	g u: t
Gute	g u: t @
Gästetualette	g E s t @ t u a: l E t @
Göethe	g 2: @ t @
Gürs	g y: 6 s
Gürße	g y: r s @
Güste	g Y s t @
Habe	h a: b @
Haben	h a: b @ n
Haftlich	h a f t l I C
Haftpflichversicherung	h a f t p f l I C v 6 z I C @ r U N
Hallo	h a l o:
Haltestele	h a l t @ S t @ l @
Haltstelle	h a l t S t E l @
Handy	h E n d i
Has	h a s
Haste	h a s t @
Hastet	h a s t @ t
Hat	h a t
Haupt	h aU p t
HauptBahnhof	h aU p t b a: n h o: f
Hauptschule	h aU p t S u: l @
HausTiren	h aU S t i r @ n
Hausartzt	h aU z a r t t s t
Hausausgabe	h aU s ? aU s g a: b @
Hause	h aU z @
Hausschue	h aU s S Y
Haustaur	h aU s t aU 6
Heben	h e: b @ n
Heeren	h e: r @ n
Heimaitland	h aI m aI t l a n t
HeimerOrt	h aI m 6 O6 t s
Heimtland	h aI m t l a n t
Heisen	h aI z @ n
Heizung	h aI ts U N
Heiß	h aI s
Helfe	h E l f @
Helfen	h E l f @ n
Helle	h E l @
Heren	h E r @ n
Herlisch	h E r l I S
Herlizche	h e:6 r l i: ts C @
Herr	h E6
Herrn	h E6 n
Hertz	h E6 t s
Hertzlich	h e:6 r t t s l I C
Hertzliche	h e:6 r t t s l I C @
Hervorragend	h E6 f o:6 r a: g @ n t
Herzlich	h E6 ts l I C
Herzliche	h E6 ts l I C @
Herzlische	h E6 t s l I S @
Heute	h OY t @
Heuzutage	h OY ts u t a: g @
Hezlichen	h E ts l I C @ n
HiearchieSystem	h i: a r C i: z Y s t e: m
Hilfbereits	h I l f b @ r aI t s
Hilfe	h I l f @
Hillfe	h I l f @
Hirzlisch	h I r ts l I S
Hoffe	h O f @
Homepege	h o m e p e: g @
Hond	h O n t
House	h aU s
Huete	h u e t @
Hundert	h U n d 6 t
Hute	h u: t @
Häse	h E z @
Höffntlich	h 9 f n t l I C
Hüner	h y: n 6
I	? i:
IT	? I t
IT-Kenntnise	? I t k E n t n I z @
IT-Kentnisse	? I t k E n t n I s @
IT-System	? I t z Y s t e: m
IT-Systemkaufman	? I t z Y s t e: m k ? aU f m a n
ITSistemkauffrau	? I t z I S t E m k aU f r aU
IWohenende	? i v o: @ n @ n d @
Ich	? I C
Ihen	? i @ n
Ihner	? i: n 6
Ihr	? i:6
Ihre	? i: r @
Ihrene	? i: r e: n @
Imigration	? I m i g r a ts j o: n
Imobilienmarkler	? i m o b i: l j @ n m a r k l 6
In	? I n
Inbesondere	? I n b @ z O n d @ r @
Industrie	? I n d U s t r i:
Industrien	? I n d U s t r i: @ n
Informatic	? I n f O6 m a ts t I k
Informatik	? I n f O6 m a: t I k
Informieren	? I n f O6 m i: r @ n
Inhen	? I n h E n
Instalbul	? I n S t a l b u: l
Instanbul	? I n S t a n b u: l
Integration	? I n t e g r a ts j o: n
Integrieren	? I n t e g r i: r @ n
Intelligent	? I n t E l I g E n t
Intensiven	? I n t E n z i: v @ n
Intensivkurs	? I n t E n z i: f k U6 s
Interesanten	? I n t e r @ z a n t @ n
Interesire	? I n t e r e z i r @
Interessiere	? I n t @ r E s i: r @
Intergration	? I n t 6 g r a: ts j o: n
International	? I n t 6 n a ts j o n a: l
Internationale	? I n t 6 n a ts j o n a: l @
Interresiert	? I n t 6 r e z i: r t
Intimsphera	? I n t I m s f e r a
Invormieren	? I n v 96 m a j e: r @ n
Irgend	? I6 g @ n t
Ist	? I s t
Istalbul	? I s t a l b u: l
Istanbub	? I s t a n b U p
Istanbull	? I s t a n b U l
Istes	? I s t @ s
It-Systemkauffrau	? I t z Y s t e: m k aU f r aU
Italianische	? i t a l j a: n I S @
Italienische	? i t a l j e: n I S @
Ja	j a
Jahen	j a: @ n
Jahr	j a: r
Jalia	j a l j a
Janaur	j a n aU 6
Jare	j a: r @
Jarh	j a r
Jeden	j e: d @ n
Jedenfall	j e: d @ n f a l
Jeder	j e: d 6
Jetz	j E t s
Jetzt	j E t s t
Jni	? i: n i
Job	dZ O p
Jonua	j O n U a
Jugenlichen	j u: g @ n l I C @ n
Jula	j u: l a
Jule	j u: l @
Junde	j U n d @
Jung	j U N
Junge	j U N @
Junger	j U N 6
Jungere	j U N @ r @
Junges	j U N @ s
Jünge	j Y N @
KUMMERT	k U m 6 t
Kaffe	k a f @
Kalt	k a l t
Kamm	k a m
Kammst	k a m s t
Kank	k a N k
Kann	k a n
Kannst	k a n s t
Kanst	k a n s t
Karte	k a r t @
Kartfahre	k a r t f a: r @
Kartoffel	k a r t O f @ l
Kaser	k a z 6
Katolick	k a t o l I k
Katolische	k a t o: l I S @
Kats	k a t s
Katz	k a t s
Kauffrau	k aU f r aU
Kaufmans	k aU f m a n s
Kaufmännischen	k aU f m E n I S @ n
Kaufmännischer	k aU f m E n I S 6
Kaufmännischerin	k aU f m E n I S @ r I n
Kaufmännliche	k aU f m E n l I C @
Kauft	k aU f t
Kein	k aI n
Keine	k aI n @
Keler	k @ l 6
Kelerraum	k @ l 6 r aU m
Kenedybrücke	k @ n I d i b r Y k @
Kennen	k E n @ n
KenniA	k E n j a
Kennst	k E n s t
Kenntnise	k E n t n I z @
Kenntniss	k E n t n I s
Kenntnisse	k E n t n I s @
Kentnise	k E n t n I z @
Kentnisse	k E n t n I s @
Kerche	k E6 r C @
Kille	k I l @
Kinder	k I n d 6
Kindern	k I n d 6 n
Kinderzimer	k I n d 6 ts i: m 6
Klagen	k l a: g @ n
Klar	k l a: r
Kleidung	k l aI d U N
Klein	k l aI n
Kleine	k l aI n @
Kleinen	k l aI n @ n
Kliens	k l i: n s
Klingt	k l I N t
Klücklich	k l Y k l I C
Koch	k O x
Kochen	k O x @ n
Koleg	k o l e: k
Kombodschnish	k O m b o: t S n I S
Komenn	k o m @ n
Komme	k O m @
Kommen	k O m @ n
Kommst	k O m s t
Kommunication	k O m j u: n k a ts j o: n
Kommunikativ	k O m u n i k a t i: f
Kompentez	k O m p @ n t @ ts
Kompliziert	k O m p l i ts i:6 t
Kompromise	k O m p r o m I z @
Komputer	k O m p j u: t 6
Komunikationbereich	k o m u n i k a ts j o: n b @ r aI C
Konditionne	k O n d i ts j o: n @
Konnen	k O n @ n
Konnte	k O n t @
Konntet	k O n t @ t
Kontekst	k O n t E k s t
Kontest	k O n t @ s t
Konventionell	k O n v E n ts j o n E l
Korrekte	k O r E k t @
Kosove	k o z o: v @
Kosten	k O s t @ n
Kostet	k O s t @ t
Kraghen	k r a: g @ n
KranK	k r a N k
Krank	k r a N k
Kranken	k r a N k @ n
KrankenHaus	k r a N k @ n h aU s
KrankenHause	k r a N k @ n h aU z @
Krankenschwster	k r a N k @ n S f s t 6
Kronk	k r O N k
Kuche	k U x @
Kucher	k U x 6
Kulter	k U l t 6
Kulteren	k U l t @ r @ n
Kultur	k U l t u:6
Kulturell	k U l t u r E l
Kulturelle	k U l t u r E l @
Kummern	k U m 6 n
KundenKontaK	k U n d @ n k O n t a k
KurSgebüren	k U6 s z u: @ b y: r @ n
Kurs	k U6 s
Kurse	k U6 z @
Kurtur	k U6 s t u:6 6
Kurz	k U6 ts
Kurzem	k U6 ts @ m
Kusen	k u: z @ n
Kuzine	k u ts i: n @
Kuß	k U s
Kätz	k E t s
Kätze	k E t s @
Kätzen	k E t s @ n
Kömischeweiser	k 2: m I S @ v aI z 6
Könen	k 2: n @ n
Können	k 9 n @ n
Könnst	k 9 n s t
Kühe	k y: @
Kümmern	k Y m 6 n
Kürche	k Y6 C @
Küsche	k Y S @
Küssen	k Y s @ n
Laden	l a: d @ n
Lage	l a: g @
Lange	l a N @
Lebe	l e: b @
Leben	l e: b @ n
Lebenslauff	l e: b @ n s l aU f f
Lebensnivo	l e: b @ n s n i v o
Leber	l e: b 6
Ledier	l e d i: @
Lehrerin	l e: r @ r I n
Leibe	l aI b @
Leiber	l aI b 6
Leider	l aI d 6
Lernen	l E6 n @ n
Leute	l OY t @
LiBe	l i: b @
Libe	l i: b @
Liber	l i: b 6
Libt	l I p t
Liebe	l i: b @
Lieber	l i: b 6
LieblingsFreund	l i: p l I N s f r OY n t
Lieder	l i: d 6
Liegt	l i: k t
Lohnen	l o: n @ n
LokaleMenschen	l o k a l e: m @ n S @ n
Lpiebe	l p i: b @
Luksemburg	l U k z @ m b U6 k g
Luset	l u: z @ t
Lustig	l U s t I C
M.fG	? E m ? E f g e:
MIER	m i: @
Machts	m a x t s
Mamma	m a m a
Man	m a n
Mann	m a n
Marketing	m a r k @ t I N
Markler	m a r k l 6
Mars	m a r s
Marz	m a r ts
Mehr	m e:6
Mehrschweinchen	m e: 6 S v aI n C @ n
Meilbox	m aI l b O k s
Mein	m aI n
Meine	m aI n @
Meinem	m aI n @ m
Meinen	m aI n @ n
Meiner	m aI n 6
Meisten	m aI s t @ n
Menagerin	m e n a: g @ r I n
Menchen	m E n C @ n
Mensch	m E n S
Mentalitet	m E n t a l i: t @ t
Merz	m E6 ts
Metoden	m E t o: d @ n
Mich	m I C
Miene	m i: n @
Miete	m i: t @
Mieten	m i: t @ n
Millonen	m I l o: n @ n
Milte	m I l t @
Mim	m I m
Ministrium	m i n I s t r i U m
Mir	m i:6
Mit	m I t
Mitagessen	m i t a: k ? E s @ n
Mitburger	m I t b t r g 6
Mitglieder	m I t g l i: d 6
Mitglieger	m I t g l i: g 6
Mitt	m I t
Mittags	m I t a: k s
Mittglied	m I t g l i: t
Mitvertrag	m I t f 6 t r a: k
Mitvertrags	m I t f 6 t r a: k s
Mobil	m o b i: l
Mobilia	m o b i: l j a
Moglichkeit	m O g l I C k aI t
Moglichkeiten	m O g l I C k aI t @ n
Morgen	m O6 g @ n
Morgens	m O6 g @ n s
Morger	m O6 k @ n 6
MosGUcollege	m O s g u k O l e: g @
Motiviert	m o t i v i:6 t
MtiFreundlichen	m t I f r OY n t l I C @ n
Muhe	m u: @
Multinationallefirma	m U l t i n a ts j o n a l e f i r m a
Mundlich	m U n t l I C
Muss	m U s
Mutte	m U t @
Muttr	m U t r
Mädchen	m E: t C @ n
Mäddchen	m E: t d C @ n
Mädschen	m E t s C @ n
Männlich	m E n l I C
Märzt	m 96 t s t
Mätchan	m E: t C a n
Mätchen	m E: t C @ n
Möchte	m 9 C t @
Mötchen	m 9 t C @ n
Mündliche	m Y n t l I C @
Müter	m y: t 6
NAIRObi	n aI r o: b i
Nach	n a: x
Nachdem	n a: x d e: m
Nahmittag	n a: m I t a: k
Naricht	n a r I C t
Naturlich	n a t u: r l I C
Nawio	n a v j o
Nawros	n a v r @ s
NebenKosten	n e: b @ n k O s t @ n
Nebenkostet	n e: b @ n k O s t @ t
Nechsten	n E C s t @ n
Nett	n E t
Nette	n E t @
Neuber	n OY b 6
Neue	n OY @
Nevou	n e: v u:
Nie	n i:
Niederland	n i: d 6 l a n t
Nike	n aI k i
Niveau	n i v o:
Niveu	n i v OY
Noch	n O x
Nocheinmal	n O x ? aI n m a: l
Nr	? E n ? E r
Nächste	n E: C s t @
Nächten	n E C t @ n
Nächter	n E C t 6
Närulich	n E: r u: l I C
Näturlich	n E: t u: r l I C
OFICCE	? o: f I k s @
Obdachlos	? O p d a x l o: s
Obenwaldstr	? o: b @ n v a l t S t r
Obenwaldstrasse	? o: b @ n v a l t S t r a: s @
Obwohl	? O p v o: l
Oder	? o: d 6
Okay	? o k e:
Olimpic	? o l I m p I k
Opa	? o: p a
Opfer	? O p f 6
Orangensaft	? o r a: Z @ n z a f t
Orientieren	? o:6 j E n t i: r @ n
Ort	? O6 t
Ostern	? o: s t 6 n
POWEREITUNG	p o v e: r aI t U N
Paar	p a: r
Papagaien	p a p a g aI @ n
ParTy	p a r t i
Parfühm	p a r f y: m
Parkplatzproblemme	p a r k p l a t s p r o b l E m @
Parktisch	p a: r k t I S
Party	p a r t i
Passen	p a s @ n
Peinlich	p aI n l I C
Perfekt	p E6 f E k t
Person	p E6 z o: n
Personnen.Ich	p E6 z o m n @ n I C
Persönlich	p E6 z 2: n l I C
Pfarmaindustrie	p f a r m a l n d U s t r i:
Pflegen	p f l e: g @ n
Pflichen	p f l I C @ n
Photos	f o: t o s
Physiotherapie	f y: z j o t e r a p i:
Pikini	p i k i: n i
Pollen	p O l @ n
Polnischkenntnisse	p O l n I S k E n t n I s @
Portugiesisch	p O6 t U N s i: z I S
Portuguesich	p O6 t U N s U @ z I C
Positiv	p o: z i t i: f
Positive	p o: z i t i: v @
Positiven	p o: z i t i: v @ n
Potho	p o t o
Praktikum	p r a k t i k U m
Praktikumsplatzt	p r a k t i k U m s p l a t s t
Praktische	p r a k t I S @
Prarktikum	p r a r k t i k U m
Preis	p r aI s
Preise	p r aI z @
Preiss	p r aI s
Pries	p r i: s
Priese	p r i: z @
Privat	p r i v a: t
Privatsfere	p r i f a: t s f @ r @
Pro	p r o:
Probeme	p r o: b @ m @
Program	p r o g r a: m
Programem	p r o g r a: m @ m
Programierer	p r o g r a m i: r 6
Projecte	p r o: j E k t @
ProsPeckte	p r o s p E k t @
Prufung	p r u: f U N
Prufüng	p r u: f Y N
Prüfen	p r y: f @ n
Prüfung	p r y: f U N
Quadrat	k v a d r a: t
Qüalität	k Y a l i t E: t
Raise	r aI z @
Raus	r aU s
Reche	r E C @
Recht	r E C t
Regen	r e: g @ n
Reich	r aI C
Rein-Neckar-Zeitung	r aI n n E k a r ts aI t U N
Reis	r aI s
Restoran	r E s t o: r a: n
Restraunts	r E s t r aU n t s
Resturant	r E s t u r a n t
Ritmus	r I t m U s
Rote	r o: t @
Rottkohl	r O t k o: l
Ruf	r u: f
Rufe	r u: f @
Rumänia	r u m E: n j a
Rumänin	r u m E: n I n
Rusisch	r u: z I S
Russicsh	r U s I k s
Russisch	r U s I S
Römaische	r 2: m aI S @
Rückkerh	r Y k k 6
S-bahn	? E s b a: n
SCHON	S o: n
SCHUSS	S U s
SPass	S p a s
SPäter	S p E: t 6
STAATSANGEHORISCHKEIT	S t a: t s ? a n g e h o: r I S k aI t
STELEN	S t e: l @ n
STambaL	S t a m b a: l
STembul	S t e: m b u: l
Sagen	z a: g @ n
Sammstag	z a m s t a: k
Samstg	z a m s t g
Samtag	z a m t a: k
Schade	S a: d @
Schef	S E f
Scheiz	S aI ts
Schencke	S E N k @
Schick	S I k
Schlaf	S l a: f
Schlafe	S l a: f @
Schlafen	S l a: f @ n
SchlafenZimmer	S l a: f @ n ts I m 6
Schlafzimer	S l a: f ts aI m 6
Schlafzimme	S l a: f ts I m @
Schlesichen	S l @ z I C @ n
Schlieslich	S l i: s l I C
Schlimmsten	S l I m s t @ n
Schlimste	S l I m s t @
Schlozimer	S l o ts i: m 6
Schlussel	S l U s @ l
Schluß	S l U s
Schlußel	S l u: s @ l
Schlüsse	S l Y s @
Schnell	S n E l
Schockolade	S O k o l a: d @
Schocolade	S o k o l a: d @
Schon	S o: n
Schpas	S p a s
Schreib	S r aI p
Schreiben	S r aI b @ n
Schribe	S r i b @
Schriftliche	S r I f t l I C @
Schrit	S r I t
Schuhblade	S u: b l a: d @
Schuhle	S u: l @
Schulabschluß	S u: l ? a p S l U s
Schule	S u: l @
Schultzt	S U l t s t
Schulusendlich	S u: l u z @ n t l I C
Schulz	S U l ts
Schussl	S U s l
Schwecter	S v E k t 6
Schweitz	S v aI t s
Schwelenländer	S v e: l @ n l E n d 6
Schwer	S v e:6
Schwerigkeiten	S v e r I C k aI t @ n
Schweßter	S v E s t 6
Schwiemmbad	S v i: m b a: t
Schwiez	S v i: ts
Schwimbad	S v I m b a t
Schwimen	S v aI m @ n
Schwimmen	S v I m @ n
Schäde	S E: d @
Schön	S 2: n
Schönes	S 2: n @ s
Seehgrte	z e: h a: r t @
Seehr	z e: r
Seer	z e: r
Segretation	z e g r e t a ts j o: n
Sehen	z e: @ n
Sehenwundigkeit	z e: @ n v U n d I C k aI t
Seher	z e: ? i: r
Sehr	z e:6
Sei	z aI
Sein	z aI n
Seine	z aI n @
Seit	z aI t
Selbstbewusstes	z E l p s t b @ v U s t @ s
Selbstängichkeit	z E l p s t E N I C k aI t
Selbsverstänlich	z E l p n s 6 S t E n l I C
Semestre	z e m E s t r @
Senter	z E n t 6
Sentrom	z E n t r o: m
Shöenen	S 2: @ n @ n
Siamese	z i a: m e: z @
Siammese	z i a m e: z @
Sie	z i:
Siet	z i: t
SilRe	z i l r @
Silviesternach	z I l v i: s t 6 n a x
Sind	z I n t
Sinergy	z aI n 6 dZ i
Sint	z I n t
Situration	z i t u r a ts j o: n
Sklawe	s k l a v @
So	z O
Sociologie	z o ts j o l o g i:
Sofort	z o f O6 t
Sohwohl	z o: v o: l
Soll	z O l
Sollst	z O l s t
Solter	z O l t 6
Sommer	z O m 6
Sona	z o: n a:
Sonder	z O n d 6
Sondern	z O n d 6 n
Sonn	z O n
Sonnstag	z O n s t a: k
Sonntagabent	z O n t a: k a b @ n t
Sont	z O n t
Sontag	z O n t a: k
Sontags	z O n t a: k s
Sovinier	z o v i n j 6
Spaaß	S p a ? a s
Spanisch	S p a: n I S
Spanisch-Lehrerin	S p a: n I S l e: r @ r I n
Spanish	S p a: n I S
Spas	S p a s
Spass	S p a s
Spatziergang	S p a t s i: E6 g a N
Spazieren	S p a ts i: r @ n
Spezielle	S p e ts j E l @
Spiel	S p i: l
Spielplaz	S p i: l p l a: ts
Spielt	S p i: l t
Sport	S p O6 t
Sprach	S p r a: x
Sprache	S p r a: x @
Sprachkentnise	S p r a: x k E n t n I z @
Sprachkentnisse	S p r a: x k E n t n I s @
Spreahe	S p r e a e:
Sprechen	S p r E C @ n
Staadt	S t a: t
Stad	S t a: t
Stadt	S t a t
Stadverwaltung	s t a t f 6 v a l t U N
Statd	S t a t d
Stelle	S t E l @
Stellen	S t E l @ n
Stlaatlichen	S t l a: t l I C @ n
Strassen	S t r a: s @ n
Streiht	S t r aI t
Stresausbau	S t r @ z ? aU s b aU
Studenten	S t u d E n t @ n
Studentin	S t u d E n t I n
Studiere	S t u d i: r @
Studieren	S t u d i: r @ n
Studire	S t u: d i r @
Stufteprufung	S t U f t @ p r u: f U N
Stunden	S t U n d @ n
Sturuktur	S t u r U k t u:6 6
Stätde	S t E t d @
Suche	z u: x @
Suchen	z u: x @ n
Super	z u: p 6
Suppe	z U p @
Suvenir	z u v @ n i r
Suwenier	z u v e: n i: @
Swimmen	s v I m @ n
Syrian	z y r j a n
System	z Y s t e: m
Systeme	z Y s t e: m @
Systemkaufman	z Y s t e: m k ? aU f m a n
Systemkaufmann	z Y s t e: m k ? aU f m a n
Söine	z 2: i: n @
Sömmer	z 9 m 6
Südamerikanische	z y: t ? a m e r i k a: n I S @
Süsse	z Y s @
Süß	z y: s
TREFEN	t r @ f @ n
TV-sehen	t e: f aU z e: @ n
Tamin	t a m i: n
Tanzen	t a n ts @ n
Tatigkeit	t a t I C k aI t
Tauch	t aU x
Tauchter	t aU x t 6
Teamfachigkeit	t @ ? a m f a x I C k aI t
Teamfähig	t @ ? a m f E: I C
Technicschule	t E C n I k S u: l @
Technologische	t E C n o l o: g I S @
Techonologie	t e: C o n o l o g i:
Tehater	t e: h a: t 6
Teil	t aI l
Teilen	t aI l @ n
Teilnehmen	t aI l n e: m @ n
Teinehmen	t aI n e: m @ n
Telefon	t e l e f o: n
Telekaffe	t e: l @ k a f @
Temer	t e: m 6
Terasse	t @ r a: s @
Tereffen	t E r E f @ n
Termalbad	t e:6 r m ? a l b a: t
Terrase	t E r a: z @
Teuer	t OY 6
Tier	t i:6
Tippich	t I p I C
Tochta	t O x t a
Toilete	t o a l @ t @
Toll	t O l
Tool	t u: l
Touch	t a tS
Tradiotionen	t r a d j o ts j o: n @ n
Tradiptionen	t r a: d I p ts j o: n @ n
Traditionelle	t r a d i ts j o n E l @
Traditiönen	t r a d i ts j 2: n @ n
Traditonen	t r a: d i t o: n @ n
Tradizionen	t r a d i ts j o: n @ n
Traum	t r aU m
Traurig	t r aU r I C
Trefen	t r @ f @ n
Treffe	t r E f @
Treffen	t r E f @ n
Trinke	t r I N k @
Trockener	t r O k @ n 6
Trozdem	t r O ts d e: m
Tschuch	t S u: x
Tschuss	t S U s
Tschuß	t S U s
Tschüs	t S y: s
Tschüse	t S y: z @
Tschüß	tS Y s
Tscüss	t S Y s
Tualete	t u a l @ t @
Tuchter	t u: x t 6
Tud	t u: t
Tun	t u: n
Turisten	t u r I s t @ n
Turkei	t t r k aI
Turkisch	t U6 s k I S
Turkische	t U6 s k I S @
Tut	t u: t
Tätichkeiten	t E: t I C k aI t @ n
Türkiche	t y: r k I C @
Türkis	t y: r k I s
U-Bahn	? u: b a: n
U-bahn	? u: b a: n
UBERSETZEN	? U b 6 z E t s @ n
UN	? U n
Uber	? U b 6
Uberzeugung	? U b 6 ts OY g U N
Uh	? u:
Uhlaub	? u: l aU p
Uhrlaub	? u:6 l aU p
Ukraina	? u k r a i: n a
Ukrainische	? u k r a i: n I S @
Und	? U n t
Ungarische	? U N g a r I S @
Univasität	? u n i v a z i t E: t
Universitätabschlusszeugniss	? u n i v E6 z i t E: E t a: p S l U s ts OY k n I s
Univesität	? u n i v e: z i t E: t
Unterhalten	? U n t 6 h a l t @ n
Unternemen	? U n t 6 n e: m @ n
Unterschide	? U n t 6 S i: d @
Unterstreiben	? U n t 6 S t r aI b @ n
Unterwegs	? U n t 6 v e: k s
Urlaubs	? u:6 l aU p s
V.	f aU
Vater	f a: t 6
Vatter	f a t 6
Veil	f aI l
Veile	f aI l @
Veilen	f aI l @ n
Veilleicht	f aI l aI C t
Velleicht	f E l aI C t
Verantwortungsvolle	f E6 ? a n t v O6 t U N s f O l @
Verein	f E6 ? aI n
Vereinbaren	f E6 ? aI n b a: r @ n
Vereine	f E6 ? aI n @
Vergessen	f E6 g E s @ n
Verhandelung	f E6 h O a n d @ l U N
Verkar	f 6 k a r
Verkaufer	f E6 k aU f 6
Verkauferin	f E6 k aU f @ r I n
Verkaufs	f E6 k aU f s
Verkaüferin	f E6 k aU Y f @ r I n
Vermesse	f E6 m 2: @ s @
Vermietler	f E6 m 2: j E t l 6
Vermiter	f E6 m 2: i: t 6
Verschidene	f E6 z I C i d @ n @
Versprochen	f E6 S p r O x @ n
Verständniss	f E6 z I t E n t n I s
Vertrag	f E6 t r a: k
VertrebPraktik	f E6 t r a: @ p U r a k t I k
VertriebPraktikant	f E6 t r a: i: p U r a k t i k a n t
Vertriebsbransche	f E6 t r a: i: p s b r a n S @
Vertriebspraktikant	f E6 t r a: i: p s p r a k t i k a n t
Vertriebspraktikanterin	f E6 t r a: i: p s p r a k t i k a n t @ r I n
Vervaltung	v 6 v a l t U N
Vie	f i:
Vieb	v i: p
Viel	f i: l
Viele	f i: l @
Vieleicht	f i: l aI C t
Vielen	f i: l @ n
Vielleich	f i l aI C
Viellen	f i: l @ n
Vielliecht	f i: l i: C t
ViertelJahr	f I6 t @ l j a: r
Viese	f i: z @
Viet	v i: t
Vigehet	v I g @ h e t
Vil	f I l
Vile	f aI l @
Vileicht	f aI l aI C t
Ville	f I l @
Villeicht	f i: l aI C t
Villst	f I l s t
Volkslider	f O l k s l i: d 6
Von	f O n
Vor	f o:6
Vorallem	f o r a l @ m
Vorauf	f o r aU f
Voraur	f o r aU 6
Vorauss	f o r aU s
Vorbereit	f o:6 r b @ r aI t
Vorgehen	f o:6 g e: @ n
Vorletzt	f o:6 r l E t s t
Vorstellung	f o:6 S t E l U N
Vorstellungsgesprach	f o:6 S t E l U N s g @ S p r a: x
Vorstellungsgesprech	f o:6 S t E l U N s g @ S p r E C
Vorstellungsgespräach	f o:6 S t E l U N s g @ S p r E: a x
VortragsGebühren	f o:6 r t r a: k s g @ b y: r @ n
Vroümlich	v r O Y m l I C
WC	v e: ts e:
WG	v e: g e:
WOLTE	v O l t @
Wahnsinnige	v a: n s I n I g @
Wahrend	v a: r @ n t
Wan	v a: n
Warm	v a r m
Warmeessen	v a r m e: @ s @ n
Wasfür	v a s f y: r
Wass	v a s
We	v E
Weiblich	v aI p l I C
Weil	v aI l
Weise	v aI z @
Wellt	v E l t
Weltweit	v E l t v aI t
Wen	v e: n
Wendu	v E n d U
Wenn	v E n
Whonung	f o: n U N
Wi	v I
Wichtig	v I C t I C
Wie	v i:
Wieget	v i: g @ t
Wiel	v i: l
Wieleicht	v i: l aI C t
Wieviele	v i: f i: l @
Wir	v i:6
Wirtschaftsuniversitat	v i: r t S a f t s u n i v E6 z i t E: a t
Wisse	v I s @
Wissen	v I s @ n
Wisum	v i z U m
Wiviel	v i v i: l
Wizich	v I ts I C
Wißt	v I s t
Wochen	v O x @ n
Wochende	v O x @ n d @
Wochendende	v O x @ n d @ n d @
Wochenede	v O x @ n e: d @
Wochenen	v O x @ n ? E n
Wochenende	v O x @ n ? E n d @
Wochnende	v O x n E n d @
Wockenende	v O k @ n E n d @
Wohe	v o h e:
Wohen	v o h e: n
Wohenende	v o: @ n @ n d @
Wohn	v o: n
Wohne	v o: n @
Wohnen	v o: n @ n
Wohneng	v o: n @ n g
Wohnheime	v o: n h aI m @
Wohnug	v o: n u: k
Wohnung	v o: n U N
Wohnungen	v o: n U N @ n
Wohnungsmarkt	v o: n U N s m a r k t
Wohnungsmöglickeiten	v o: n U N s m 2: k l I k aI t @ n
Wohnungssuche	v o: n U N s z u: x @
Wohnungsvermarklern	v o: n U N s f 6 m a r k l 6 n
Wohnunsuchen	v o: n U n z u: x @ n
Wohnzimer	v o: n ts i: m 6
Wohung	v o h U N
Wohungsmarkt	v o h U N s m a r k t
Wollte	v O l t @
Won	v O n
Wonhaung	v O n h aU N
Wonung	v o: n U N
Währen	v E: r @ n
Wäre	v E: r @
Wünsch	v Y n S
Wünsche	v Y n S @
Würde	v Y6 d @
Würzel	v y: r ts @ l
X-Centrum	? I k s ts E n t r U m
X.	? I k s
Z.B.	ts E t b e:
Zait	ts aI t
Zeit	ts aI t
Zeitug	ts aI t u: k
Zentral	ts E n t r a: l
Zenturm	ts E n t U6 s m
Zertifikat	ts E6 t s i: f i k a t
Zigarreten	ts i g a r e: t @ n
Zimer	ts aI m 6
Zimmer	ts I m 6
Zimmern	ts I m 6 n
Zimmerwohnung	ts I m 6 v o: n U N
Zu	ts u
Zug	ts u: k
ZugTicket	ts u: k t I k @ t
Zukunf	t s u: k U n f
Zum	ts U m
Zuruck	ts u r U k
Zurück	ts u r Y k
Zusammendfassung	ts u z a m @ n t f a s U N
Zussamen	ts u s z a m @ n
Zussammenfassend	ts u s z a m @ n f a s @ n t
Zusätzliche	t s u: z E t s l I C @
Zwangemassnahmen	ts v a N @ m a s n a: m @ n
Zwei	ts v aI
Zweifllos	ts v aI f l o: s
Zweite	ts v aI t @
Zügehorigkeit	ts y: g e h o: r I C k aI t
abar	? a p a r
abe	? a: b E:
abend	? a: b @ n t
aber	? a: b 6
abere	? a: b @ r @
ablehnung	? a p l e: n U N
abreite	? a p r aI t @
abreiten	? a p r aI t @ n
abschluss	? a p S l U s
abwechlungsreiche	? a p v E C l U N s r aI C @
abzuschlißen	? a p ts u S l I s @ n
ach	? a x
achter	? a x t 6
aien	? aI @ n
ain	? aI n
ainem	? aI n @ m
akceptieren	? a k C @ p t i: r @ n
aktiviten	? a k t i v i: t @ n
aktivitäten	? a k t I v I t E: t @ n
alagie	? a l a g i:
alein	? a l aI n
aleine	? a l aI n @
ales	? a: l @ s
allergi	? a l 6 g i
allergich	? a l 6 g I C
alles	? a l @ s
alless	? a l @ s
alliene	? a l i: n @
alls	? a l s
alsäsich	? a l z E: z I C
am	? a m
amderen	? a m d @ r @ n
amnelden	? a m n @ l d @ n
anZuschließen	? a n ts u S l i: s @ n
anbietten	? a n b i: t @ n
and	? E: n t
andare	? a n d a: r @
andaren	? a n d a: r @ n
andree	? a n d r e:
andwohrt	? a n t v o: r t
anfang	? a n f a N
anfanger	? a n f a N 6
angenem	? a n g @ n @ m
angepast	? a n g @ p a s t
angfan	? a n g f a: n
angobot	? a n g o b o: t
anie	a n j @
anntworht	? a n t v 96 h O t
anruf	? a n r u: f
ansprusvollen	? a n s p r U s v O l @ n
ant	? a n t
antretten	? a n t r E t @ n
antworht	? a n t v 96 h O t
antwort	? a n t v O6 t
antworten	? a n t v O6 t @ n
antworter	? a n t v 96 t @ n 6
antwörte	? a n t v 96 t @ l
anzeige	? a n ts aI g @
anzeigen	? a n ts aI g @ n
april	? a p r I l
arbaite	? a r b aI t @
arbeit	? a r b aI t
arbeite	? a r b aI t @
arbeitzplatz	? a r b aI t s p l a t s
arbetet	? a r b e: t @ t
arbischen	? a r b I S @ n
arbite	? a r b i: t @
arzt	? a r ts t
ashraiben	? a s r aI b @ n
auf	? aU f
aufenthaltsformalitäten	? aU f ? E n t h a l t s f O r m a l i t E: t @ n
aufgaben	? aU f g a: b @ n
aufgewachen	? aU f g @ v a x @ n
aufhehmen	? aU f h e: m @ n
aufhällt	? aU f h E l t
aufmerksamm	? aU f m 6 k z a m
aufpasen	? aU f p a z @ n
auftrende	? aU f t r E n d @
august	? aU g U s t
ausbildung	? aU s b I l d U N
ausblicke	? aU s b l I k @
ausdurücken	? aU s d u r Y k @ n
ausflug	? aU s f l u: k
ausgesehen	? aU s g @ z e: @ n
ausland	? aU s l a n t
auslandische	? aU s l a n d I S @
auslandischen	? aU s l a n d I S @ n
ausländer	? aU s l E n d 6
ausnahmen	? aU s n a: m @ n
auspassen	? aU s p a s @ n
ausschlaggeben	? aU s S l a: k g e: b @ n
ausserdem	? aU s 6 d e: m
ausserhalb	? aU s 6 h a l p
aussprache	? aU s S p r a: x @
auswelst	? aU s v E l s t
auswälen	? aU s v E: l @ n
auto	? aU t o
azelen	? a: ts e: l @ n
babY	b e: b i
baby	b e: b i
bad	b a: t
badenhose	b a: d @ n h o: z @
bahnhofstraße	b a: n h o: f S t r a: s @
balkon	b a l k O N
ball	b a l
balld	b a l t
band	b a n t
bauernfrühstück	b aU 6 n f r y: S t Y k
be	b @
beby	b @ b i
bebys	b @ b i s
bechuchen	b E C U x @ n
beckomen	b E k o: m @ n
beckommen	b E k O m @ n
becommen	b E k O m @ n
beeinflüssen	b @ ? aI n f l Y s @ n
befindt	b @ f I n t t
begine	b @ g i: n @
beginn	b @ g I n
behersche	b @ h 6 S @
beherschen	b @ h 6 S @ n
bei	b aI
beidir	b aI d i r
beispiel	b aI S p i: l
bekannte	b @ k a n t @
bekleidung	b @ k l aI d U N
bekomen	b @ k o: m @ n
bemerkungen	b @ m E6 k U N @ n
benantworten	b @ n a n t v 96 t @ n t
benuzen	b @ n U ts @ n
bereich	b @ r aI C
bereiten	b @ r aI t @ n
bereuhen	b @ r OY h @ n
beringen	b @ r I N @ n
beringst	b @ r I N s t
berlin	b E6 l i: n
berüflich	b @ r Y f l I C
besahlen	b @ z a: l @ n
besauch	b @ z aU x
bescheftig	b @ S E f t I C
bescheid	b @ S aI t
beschid	b @ S I t
beschwehren	b @ S v e: r @ n
beschwerde	b @ S v e:6 d @
beschäftig	b @ S E f t I C
beschäftigd	b @ S E f t I C t
beschäftlich	b @ S E f t l I C
beser	b @ z 6
besichtigung	b @ z I C t I g U N
besoche	b @ z O x @
besonder	b @ z O n d 6
besondern	b @ z O n d 6 n
besonderten	b @ z O n d 6 t @ n
bessten	b @ s t @ n
beste	b E s t @
bestet	b @ s t @ t
bestimmteten	b @ S t I m t @ t @ n
bestimtes	b @ S t I m t @ s
besuch	b @ z u: x
besuhen	b @ z u: @ n
besunderes	b @ z U n d @ r @ s
besuschen	b @ z U S @ n
betracht	b @ t r a x t
betreuung	b @ t r OY U N
betrieb	b @ t r i: p
betrift	b @ t r I f t
bett	b E t
bette	b E t @
betzal	b E t s a l
bevore	b @ v o: r @
bevorzügt	b @ v 96 t s ? y: k t
beweisst	b @ v aI s t
bewohner	b @ v o: n 6
bezahlung	b @ ts a: l U N
bezaht	b @ ts a: t
bezalen	b @ ts a: l @ n
bezhalen	b @ ts h a: l @ n
bezüglich	b @ ts y: k l I C
bie	b i:
biebe	b i: b @
biedake	b i: d a: k @
bier	b i:6
biette	b i: t @
bikini	b I k i: n i
bild	b I l t
bis	b I s
bisbaldige	b I s b a l d I g @
bischen	b I S @ n
bischje	b I S Z @
bisjetzt	b I s dZ E t s t
biss	b I s
bisshen	b I s h @ n
bist	b I s t
bisüche	b i z Y C @
bitt	b I t
bitte	b I t @
bitter	b I t 6
blieben	b l i: b @ n
brache	b r a: x @
brachen	b r a: x @ n
braf	b r a f
brauchtman	b r aU x t m a: n
brauchts	b r aU x t s
braughe	b r aU g @
breibe	b r aI b @
brief	b r i: f
briefe	b r i: f @
brif	b r i: f
brifkasten	b r I f k a s t @ n
bringen	b r I N @ n
bringst	b r I N s t
budhische	b u t h I S @
bugeln	b u g @ l n
burger	b 96 g 6
bus	b U s
bytte	b i t @
bäldige	b E l d I g @
bücher	b y: C 6
ca	k a
cca	k a
central	ts E n t r a: l
centrem	ts E n t r e: m
ch	ts e: h a:
chance	S a: s @
characterizieren	k a r a k t @ r i ts i: r @ n
chef	S E f
cheff	S E f
chf	ts e: h a: ? E f
chi	S i
chips	tS I p s
chr	ts e: h a: ? E r
christos	k r I s t o s
cirka	s i r k a
club	k l U p
coola	k u: l a
da	d a
dafur	d a f U6 s
dagibt	d a g i: p t
daine	d aI n @
danie	d a: n j @
daniela	d a n j e: l a
dank	d a N k
dante	d a n t @
dar	d a: r
darf	d a r f
daruber	d a r u: b 6
daruf	d a r u: f
das	d a s
dashalb	d a: s h a l p
dass	d a s
daswegen	d a: s v e: g @ n
daueraufenthalt	d aU 6 ? aU f ? E n t h a l t
daß	d a s
de	d e
dem	d e: m
den	d e: n
denoch	d e: n O x
der	d e:6
desalbe	d E s ? a l b @
deschalb	d E S a l p
desen	d e z @ n
deshalb	d E s h a l p
deshalf	d @ s h a l f
desswegen	d E s v e: g @ n
deswegen	d E s v e: g @ n
deutsch	d OY t S
deutsch-sprächige	d OY t S S p r E: C I g @
deutschen	d OY t S @ n
deutscher	d OY t S 6
deutskurs	d OY t s k U6 s
dichnach	d I C n a x
die	d i:
diena	d i: n a
dier	d i:6
dies	d i: s
dieseam	d i: z @ ? a m
diesemn	d i: z E m n
dinge	d I N @
direk	d i r E k
dirrekte	d I r r E k t @
disch	d I S
dise	d aI z @
disem	d aI z @ m
diser	d aI z 6
dises	d aI z @ s
dissen	d I s @ n
do	d o
dorauf	d o: r aU f
dos	d O s
drauf	d r aU f
drei	d r aI
drei-Zimmer	d r aI ts I m 6
dringed	d r I N @ t
drinken	d r I N k @ n
du	d u:
duetschkentnisse	d u E t S k E n t n I s @
duker	d u k 6
durchgefuhrtene	d U6 C f g @ f u: r t @ n @
dushen	d U s h @ n
däfur	d E: f U6 s
dürch	d y: r C
e-mail	? e: m e: l
e-mal	? e: m a: l
ehefrau	? e: @ f r aU
ehemalichen	? e: @ m ? a l I C @ n
ehlich	? e: l I C
eifach	? aI f a x
eiginständig	? aI g I n S t E n d I C
eigner	? aI g n 6
ein	? aI n
einandem	? aI n a n d @ m
einander	? aI n a n d 6
einbischen	? aI n b I S @ n
einbisschen	? aI n b I s S @ n
eindruck	? aI n d r U k
eingang	? aI n g a N
eingeladung	? aI n g @ l a: d U N
eingene	? aI n g @ n @
eingenem	? aI n g @ n @ m
eingentlich	? aI n g @ n t l I C
einkommen	? aI n k O m @ n
einladung	? aI n l a: d U N
einprojektwohnung	? aI n p r o j E k t v o: n U N
eintlich	? aI n t l I C
einzel	? aI n ts @ l
einzimmer	? aI n ts I m 6
elebensbedinungen	? e l e: b @ n s b @ d I n U N @ n
elektrotechik	? e l E k t r o t ? e C I k
ellein	? E l aI n
eltern	? E l t 6 n
email	? i: m e: l
emfehle	? E m f e: l @
empehlenswert	? E m p e: l @ n s v 6 t
empfele	? E m p f e l @
empfelle	? E m p f @ l @
empfellen	? E m p f @ l @ n
empfolen	? E m p f o: l @ n
ende	? E n d @
endeausflug	? E n d @ ? aU s f l u: k
endecken	? E n d E k @ n
enden	? E n d @ n
endern	? E n d 6 n
englisch	? E N l I S
enschieden	? E n S i: d @ n
entlich	? E n t l I C
entschiden	? E n t S i: d @ n
entschprechen	? E n t S p r E C @ n
entsprechend	? E n t S p r E C @ n t
enttäucht	? E n t t OY C t
enzeige	? E n ts aI g @
erKlären	? E6 k l E: r @ n
erfachren	? E r f a x r @ n
erfahrung	? E6 f a: r U N
erfahrungen	? E6 f a: r U N @ n
erfaren	? E r f a: r @ n
erfarungen	? E r f a: r U N @ n
erforgleicher	? E r f O6 k @ l aI C 6
erinerre	? e r i n E r @
erkleren	? E6 p k l @ r @ n
erlaubnis	? E6 l aU p n I s
erlenen	? E6 r l @ n @ n
erläuten	? E6 b l OY t @ n
erläutet	? E6 b l OY t @ t
ermütigen	? E6 r m y: t I g @ n
ernährung	? E6 n E: r U N
errinert	? E6 r i: n 6 t
erst	? e:6 s t
erstatet	? E r S t a t @ t
erstauntlich	? E r S t aU n t l I C
ersähen	? E r z E: @ n
ertens	? E6 r t @ n s
erzahlen	? E6 m ts a: l @ n
erzahlst	? E6 m ts a: l s t
erzehlt	? E6 m ts e: l t
esen	? e: z @ n
essen	? E s @ n
etsprechen	? E t S p r E C @ n
etweder	? E t v e: d 6
etzt	E t s t
eueren	? OY @ r @ n
eurapischen	? OY r a p I S @ n
euro	? OY r o
europisch	? OY r o: p I S
examten	? E k s a m t @ n
exestierte	? E k s E s t i: r t @
fach	f a x
fachleute	f a x l OY t @
fahrKarte	f a: r k a: r t @
fahrkarte	f a: r k a: r t @
fahrkarten	f a:6 k a6 t @ n
fahrrad	f a: r r a: t
faien	f aI @ n
fall	f a l
falls	f a l s
famile	f a m aI l @
familials	f a m i l j a: l s
familie	f a m i: l j @
familien	f a m i: l j @ n
familiere	f a m i l i: r @
famillie	f a m I l i:
faren	f a: r @ n
farhe	f a r @
fazienierende	f a ts j e n i: r @ n d @
feien	f aI @ n
feiren	f aI r @ n
fenster	f E n s t 6
fer	f E6 6
ferdint	f 6 d I n t
fergesen	f 6 g @ z @ n
festgestelt	f E s t g @ S t @ l t
feuerwerk	f OY 6 v 6 k
fharen	f h a: r @ n
fiel	f i: l
fiele	f i: l @
fielleicht	f i: l l aI C t
fil	f i: l
fill	f I l
firma	f I6 m a
firme	f I r m @
fitt	f I t
fitter	f I t 6
flasche	f l a S @
fleisch	f l aI S
flexibil	f l E k s i b i: l
flexibl	f l E k s i: b l
flexible	f l E k s i: b l @
flige	f l I g @
flissend	f l I s @ n t
flugen	f l u: g @ n
fluzoig	f l u: ts o: I C
flüttern	f l Y t 6 n
foher	f OY h 6
folgenden	f O l g @ n d @ n
for	f O6
forgesest	f O6 k @ l z E s t
formalitäte	f O r m a l i t E: t @
formalitäten	f O6 m a l i t E: t @ n
forsetzen	f O6 z o e t s @ n
forzusetzen	f O6 t s u z E t s @ n
fotos	f o: t o s
fotsetzen	f O t s E t s @ n
frage	f r a: g @
fragen	f r a: g @ n
französiche	f r a n ts 2: z I C @
französisch	f r a n ts 2: z I S
frau	f r aU
freindlichen	f r aI n t l I C @ n
freitag	f r aI t a: k
freizeit	f r aI ts aI t
freizeitaktivitäten	f r aI ts aI t ? a k t i v i t E: t @ n
fremd	f r E m t
fremdesprache	f r E m d @ S p r a: x @
frendlichen	f r E n t l I C @ n
freuch	f r OY C
freude	f r OY d @
freudin	f r OY d i: n
freudlche	f r OY t l C @
freudlisch	f r OY d l I S
freumich	f r OY m I C
freund	f r OY n t
freunde	f r OY n d @
freunden	f r OY n d @ n
freundilichen	f r OY n d i l I C @ n
freundin	f r OY n d I n
freundlich	f r OY n t l I C
freundlile	f r OY n d l aI l @
freundlinchen	f r OY n d l I n C @ n
freundlinen	f r OY n d l aI n t
freundlischen	f r OY n d l I S @ n
freuntlich	f r OY n t l I C
freutlich	f r OY t l I C
frgen	f r g @ n
frish	f r I S
frißt	f r I s t
fro	f r o
froen	f r O n t
frohe	f r o: @
frohen	f r o: @ n
froidlihen	f r OY d l I d n
froind	f r o ? I n t
froindin	f r o ? I n d I n
fruendlech	f r y: n t l E C
fruet	f r u e t
frundlichen	f r U n t l I C @ n
fröh	f r 2:
frühstück	f r y: S t Y k
frülig	f r Y l I C
funf	f U n f
funfzehn	f U n f ts e: n
funfzig	f U n f ts I C
fur	f U6 s
futer	f u: t 6
futern	f u: t 6 n
futtern	f U t 6 n
fähigkeiten	f E: I C k aI t @ n
fühelen	f y: ? e l @ n
gamacht	g a m a x t
gans	g a n s
garage	g a r a: Z @
garden	g a r d @ n
garn	g a r n
gaz	g a ts
geKauf	g @ k aU f
geKauft	g @ k aU f t
geburien	g @ b u: r j @ n
geburstag	g @ b U6 s t a: k
geburt	g @ b u:6 t
geburtstag	g @ b u:6 t s t a: k
geburtstags	g @ b u:6 t s t a: k s
gedanken	g @ d a N k @ n
geegnite	g e: g n aI t @
geeharter	g e: h a r t 6
geehert	g e: h 6 t
geeherte	g e: h 6 t @
geeherter	g e: h 6 t 6
geehte	g e: t @
geerhte	g @ n r t @
geerte	g @ n r t @
gefahlt	g @ f a: l t
gefaiert	g @ f E i: r t
gefalen	g @ f a: l @ n
gefalt	g @ f a l t
gefelt	g @ f E l t
gefreuecht	g @ f r OY @ C t
gefroht	g @ f r o: t
gefruet	g @ f r u e t
gefuhrt	g @ f u: r t
gefunen	g @ f u: n @ n
gefällen	g @ f E l @ n
gefält	g @ f E l t
gegenteil	g e: g @ n t aI l
gegesen	g @ g @ z @ n
geh	g e:
gehee	g @ h e:
geheert	g @ h e: r t
geheerte	g @ h e: r t @
geherte	g e: ? i: r t @
geherteDamen	g e: ? i: r t E d a: m @ n
gehest	g @ h E s t
gehet	g @ h e t
gehetdir	g @ h E t d i r
gehort	g @ h O6 t s
gehrten	g @ r t @ n
gehst	g e: s t
gehsundheit	g e: z a n t h aI t
geht	g e: t
gehtes	g e: t @ s
gehts	g e: t s
gehtter	g e: t t 6
geh´s	g @ s
geit	g aI t
gekrigt	g @ k r I C t
gelachelt	g @ l a x @ l t
geld	g E l t
geleasen	g @ l e: a: z @ n
geleseh	g @ l e: z e:
gelessen	g @ l E s @ n
gemusse	g @ m U s @
gemutlich	g @ m u: t l I C
genau	g @ n aU
generation	g e n @ r a ts j o: n
generel	g @ n @ r e l
genomen	g @ n o: m @ n
genr	g @ n r
genugend	g @ n U g @ n t
gepfligt	g @ p f l I C t
geplannt	g @ p l a n t
gerechtlich	g @ r E C t l I C
gerrhte	g E r t @
gesamt	g @ z a m t
geschenk	g @ S E N k
geschenke	g @ S E N k @
geschoss	g @ S O s
geschprech	g @ S p r E C
geschprechen	g @ S p r E C @ n
geschprochen	g @ S p r O x @ n
geschreiben	g @ S r aI b @ n
geschriben	g @ S r i b @ n
geschtrichen	g @ S t r I C @ n
geschwester	g @ S v E s t 6
geseen	g @ z e: n
gesprochende	g @ S p r O x @ n d @
gespräch	g @ S p r E: C
gestallten	g @ S t a l t @ n
gesundheit	g @ z U n t h aI t
gesuntcheit	g @ z U n t C aI t
get	g E t
getes	g @ t @ s
geth	g E t
getrenk	g @ t r @ n k
getreumt	g @ t r OY m t
gevunden	g @ v U n d @ n
gewaht	g @ v a: t
gewecht	g @ v E C t
gewisen	g @ v i: z @ n
gewiß	g @ v I s
gewonen	g @ v o: n @ n
geworen	g @ v o: r @ n
gewäht	g @ v E: t
gewält	g @ v E l t
gewäsen	g @ v E: z @ n
gezeicht	g @ ts aI C t
gezetsliche	g @ ts E t s l I C @
gibt	g i: p t
gibtes	g i: p t @ s
giebt	g i: p t
giest	g i: s t
glabe	g l a: b @
glass	g l a: s
globaliesirte	g l o b a: l j e z I r t @
globaliziert	g l o b a l i ts j 6 t
gluchlich	g l u: x l I C
glück	g l Y k
glücklisch	g l Y k l I S
glückwunsch	g l Y k v U n S
glückwünsch	g l Y k v Y n S
glückwünsche	g l Y k v Y n S @
glüclich	g l Y k l I C
glüklinck	g l Y k l I N k
grosen	g r o: z @ n
grosse	g r o: s @
grossem	g r o: s e: m
grossen	g r o: s @ n
grosser	g r o: s 6
großmutter	g r o: s m U t 6
großteil	g r o: s t aI l
grunglich	g r U N l I C
grusse	g r u: s @
gruße	g r u: s @
grußen	g r u: s @ n
grösster	g r 2: s t 6
größe	g r 2: s @
größem	g r 2: s @ m
gründe	g r Y n d @
grüssen	g r Y s @ n
grüße	g r y: s @
grüßen	g r y: s @ n
gummi	g U m i
gund	g U n t
gunstig	g U n s t I C
gunstiger	g U n s t I g 6
gute	g u: t @
gutes	g u: t @ s
gutte	g U t @
gäfell	g E: f @ l
günstiga	g Y n s t i: g a
güsting	g Y s t I N
güt	g y: t
güte	g y: t @
habem	h a: b @ m
hastu	h a s t u
hate	h a: t @
hatest	h a: t E s t
hatt	h a t
haus	h aU s
hause	h aU z @
haustiere	h aU s t i: r @
heimweh	h aI m v e:
heir	h aI 6
heisst	h aI s t
heist	h aI s t
helfe	h E l f @
helfen	h E l f @ n
herzlische	h E6 t s l I S @
heuzutage	h OY ts u t a: g @
hilf	h I l f
hilfbereich	h I l f b @ r aI C
hilfe	h I l f @
hilfen	h I l f @ n
hilfsbereich	h I l f s b @ r aI C
hinfahern	h I n f a: 6 n
hinnen	h I n @ n
hir	h I r
hist	h I s t
hoben	h o: b @ n
hochdie	h o: x d j @
hofe	h o: f @
hoh	h o:
holfe	h O l f @
hollen	h O l @ n
hopfe	h O p f @
horen	h o: r @ n
house	h aU s
houte	h u: t @
hund	h U n t
hunde	h U n d @
hundert	h U n d 6 t
hunt	h U n t
husky	h a s k i
hute	h u: t @
häte	h E t @
häßt	h E s t
höfe	h 2: f @
höffe	h 9 f @
höffen	h 9 f @ n
höfflich	h 9 f l I C
höhe	h 2: @
hökstens	h 2: k s t E n s
hörren	h 2: r @ n
i	? i:
ich	? I C
ideall	? i d e a l
idee	? i d e:
identität	? i d E n t i t E: t
ien	i: n
ihnen	? i: n @ n
ihre	? i: r @
ihren	? i: r @ n
ihrergrosse	? i: r 6 g r o: s @
im	? I m
immen	? I m @ n
immernoch	? I m 6 n O x
in	? I n
inder	? I n d 6
indiesem	? I n d i: z @ m
informatiker	? I n f O6 m a ts t I k 6
information	? I n f O6 m a ts j o: n
informationen	? I n f O6 m a ts j o: n @ n
ingerdwelche	? I N 6 t v @ l C @
ingo	? I N g o
innerhalbe	? I n 6 h a l b @
innteressiere	? I n t @ r E s i: r @
inserat	? I n z e: r a: t
integrationsprozes	? I n t e g r a ts j o: n s p r O ts @ s
integriren	? I n t e g r i r @ n
inteligente	? I n t @ l I g E n t @
interculturelle	? I n t 6 k U l t u r E l @
interesant	? I n t e r @ z a n t
interesiere	? I n t e r e z i: r @
interesiert	? I n t e r e z i: r t
interesire	? I n t e r e z i r @
interess	? I n t @ r E s
interessand	? I n t @ r E s a n t
interesse	? I n t @ r E s @
interessere	? I n t @ r E s @ r @
interessire	? I n t @ r E s i r @
interessirt	? I n t @ r E s i r t
internationeler	? I n t 6 n a ts j o n @ l 6
internet	? I n t 6 n E t
interressante	? I n t 6 r @ s a n t @
interressiere	? I n t 6 r E s i: r @
interressiert	? I n t 6 r E s i: r t
intersante	? I n t 6 z a n t @
intersieren	? I n t 6 z i: r @ n
interssant	? I n t 6 s z a n t
intigrieren	? I n t i g r i: r @ n
intigriert	? I n t i g r i: r t
intinsiv	? I n t I n z i: f
intressant	? I n t r E s a n t
intresse	? I n t r E s @
intrnational	? I n t 6 n a ts j o n a: l
invohrmieren	? I n f o r m i: r @ n
ir	? I6
ire	? i: r @
is	? I s
islanbulischen	? i: s l a n b u l I S @ n
ist	? I s t
istanbul	? I s t a m b u: l
istas	? I s t a: s
jahr	j a: r
jahre	j a: r @
japanisch	j a p a: n I S
jedentag	j e: d @ n t a: k
jeder	j e: d 6
jens	j E n s
jetes	j e: t @ s
jets	j E t s
jetst	j E t s t
jetz	j E t s
jezt	j E s t
jezts	j E s t s
junge	j U N @
jungsten	j U N s t @ n
kan	k a n
kannst	k a n s t
kanst	k a n s t
kaput	k a p U t
karte	k a r t @
katz	k a t s
katze	k a t s @
katzen	k a t s @ n
katzenvell	k a t s @ n f E l
kauffrau	k aU f r aU
kegommt	k e: g O m t
keinesweg	k aI n @ s v e: k
keite	k aI t @
kennen	k E n @ n
kenntnisse	k E n t n I s @
kentnesse	k E n t n E s @
kentnisse	k E n t n I s @
kin	k I n
kind	k I n t
kinder	k I n d 6
kleidung	k l aI d U N
kollegin	k O l e: g I n
kommen	k O m @ n
kommern	k O m 6 n
kommst	k O m s t
komplet	k O m p l @ t
komst	k O m s t
komunizeren	k o m u n i ts @ r @ n
kontakt	k O n t a k t
kontaktfreuidige	k O n t a: k t f r OY d I g @
konzert	k O n ts E6 t
kosstet	k O s t @ t
koste	k O s t @
kostenloss	k O s t @ n l O s
krang	k r a N
krankenhaus	k r a N k @ n h aU s
krankenpfleger	k r a N k @ n p f l e: g 6
kroketen	k r o k e: t @ n
kuche	k U x @
kultur	k U l t u:6
kulturen	k U l t u: r @ n
kummern	k U m 6 n
kummert	k U m 6 t
kummerte	k U m 6 t @
kurs	k U6 s
kurtze	k U6 s t t s @
kusche	k U S @
kusse	k U s @
kusst	k U s t
kw	k a: v e:
kännst	k E n s t
könenn	k 2: n @ n
können	k 9 n @ n
könte	k 9 n t @
küch	k Y C
künstlische	k Y n s t l I S @
land	l a n t
lander	l a n d 6
landes	l a n d @ s
langjehrige	l a N j e: r I g @
langsamm	l a N z a m
lebe	l e: b @
lebem	l e: b @ m
leben	l e: b @ n
lebensmittel	l e: b @ n s m I t @ l
lehrnen	l E 6 n @ n
leide	l aI d @
leidenchaftlig	l aI d @ n k a f t l I C
leider	l aI d 6
leit	l aI t
lernen	l E6 n @ n
lernenen	l E6 n j @ n @ n
lesen	l e: z @ n
leser	l e: z 6
leste	l E s t @
letze	l E t s @
leuft	l OY f t
leute	l OY t @
leuten	l OY t @ n
libe	l i: b @
liblingsfreunde	l I b l I N s f r OY n d @
liebe	l i: b @
lieblings	l i: p l I N s
ltztes	l t s t @ s
lust	l U s t
läcker	l E k 6
länder	l E n d 6
länga	l E N g a
löckeren	l 9 k @ r @ n
lösst	l 9 s t
lösung	l 2: z U N
m	? E m
machen	m a x @ n
mail	m e: l
maine	m aI n @
mal	m a: l
mall	m a l
mann	m a n
mannlich	m a n l I C
mannschaft	m a n S a f t
mantel	m a n t @ l
markplatz	m a r k p l a t s
marokko	m a r O k o
marz	m a r ts
matur	m a t u:6 6
max	m a k s
mehrstockigen	m e: 6 S t O k I g @ n
meie	m aI @
meihne	m aI n @
meine	m aI n @
meinlich	m aI n l I C
meinung	m aI n U N
meisten	m aI s t @ n
meite	m aI t @
menschen	m E n S @ n
mentalität	m E n t a l i t E: t
merschweichen	m 96 z I C v aI C @ n
merz	m E6 ts
metre	m @ t r @
mhrr	? E m h a: ? E r ? E r
miTnehmen	m I t n e: m @ n
mia	m i: a
michae	m I C a e:
michael	m I C a e: l
mier	m i: @
miete	m i: t @
mieten	m i: t @ n
milch	m I l C
milion	m i l j o: n
millionen	m I l j o: n @ n
minderjahrige	m I n d 6 j a: r I g @
minderjährige	m I n d 6 j E: r I g @
mindesten	m I n d @ s t @ n
minimum	m i: n i m U m
minute	m i n u: t @
minuten	m i n u: t @ n
mir	m i:6
mirch	m i r C
misterieuse	m I s t @ r i: ? u z @
mit	m I t
mitarbeiter	m I t ? a r b aI t 6
mitbrigem	m I t b r I g @ m
mitnehemen	m I t n @ h e m @ n
mitt	m I t
mittagessen	m I t a: k ? E s @ n
mitte	m I t @
mittel	m I t @ l
mittelweile	m I t @ l v aI l @
mobil	m o b i: l
mochte	m O x t @
moglich	m O g l I C
moglichkeit	m O g l I C k aI t
moglichst	m O g l I C s t
moglisch	m O g l I S
moment	m o m E n t
momenten	m o m E n t @ n
monad	m o: n a: t
monart	m o: n a r t
monat	m o: n a t
monate	m o: n a t @
monaten	m o: n a t @ n
mongen	m O N @ n
monot	m o: n O t
montag	m o: n t a: k
morgen	m O6 g @ n
moschte	m O S t @
multikulturelen	m U l t i k U l t u r e l @ n
mundlich	m U n t l I C
museum	m u z e: U m
mussen	m U s @ n
must	m U s t
mutter	m U t 6
muttur	m U t u:6 6
muß	m U s
mußen	m u: s @ n
mächte	m E C t @
mädchen	m E: t C @ n
märz	m E6 ts
märz-2012	m E6 ts
möche	m 9 C @
möchtst	m 9 C t s t
möglich	m 2: k l I C
möglichkeit	m 2: k l I C k aI t
möglichkeiten	m 2: k l I C k aI t @ n
möglichs	m 2: k l I C s
möschte	m 9 S t @
müheloss	m y: ? e l o: s
müller	m Y l 6
müssTe	m Y s t @
nachbarine	n a x b a: r i: n @
nacheste	n a: x @ s t @
nachmitag	n a: x m I t a: k
nachmittag	n a: x m I t a: k
nachste	n a: x s t @
nachsten	n a: x s t @ n
nacht	n a x t
nachte	n a: x t @
nachteile	n a: x t aI l @
nachweisern	n a: x v aI z 6 n
naher	n a:6
nam	n a m
name	n e I m
naturlich	n a t u: r l I C
nberen	n b @ r @ n
nebengusten	n e: b @ n g ? U s t @ n
nebenkosten	n e: b @ n k O s t @ n
nebenmeine	n e: b e n m aI n @
nechst	n e: C s t
nechste	n E C s t @
necksten	n E k s t @ n
neh	n e:
nehemen	n e h e m @ n
nehme	n e: m @
nehmen	n e: m @ n
neigerungen	n aI g @ r U N @ n
nekste	n E k s t @
nemanden	n e: m a n d @ n
neme	n e: m @
nemen	n e: m @ n
neste	n E s t @
neubauWohnung	n OY b aU v o: n U N
neuenzehnten	n OY @ n ts e: n t @ n
neues	n OY @ s
neugierieg	n OY g i: r i: k
neun	n OY n
nexte	n E k s t @
nich	n I C
nichT	n I C t
nichst.Glücklicherweise	n I C s t g l Y k l I C 6 v aI z @
nicht	n I C t
niederlassung	n i: d 6 l a s U N
niederlassungsorte	n i: d 6 l a s U N s f r t @
niht	n I t
nimanden	n I m a n d @ n
noch	n O x
nomaleweise	n o m a: l @ v aI z @
nord	n O6 t
nue	n u E
number	n a m b 6
nummer	n U m 6
näche	n E: C @
nächte	n E C t @
nächten	n E C t @ n
näechste	n E: @ C s t @
nähe	n E: @
nästern	n ? E s t 6 n
nür	n ? y: r
obengennanten	? o: b @ n g @ n a n t @ n
oberal	? o: b @ r a: l
objekte	? O p j E k t @
obst	? o: p s t
obwol	? O p v O l
oda	? o: d a
odenwaldstraße	? o: d @ n v a l t S t r a: s @
oder	? o: d 6
ofen	? o: f @ n
offe	? O f @
offentlichen	? O f @ n t l I C @ n
offentlicheverkehrsmittel	? O f @ n t l I C @ f 6 k e: 6 s m I t @ l
officeprogramme	? O f i ts E p r o g r a m @
offnen	? o f n @ n
ohnu	? O n u:
oke	? o k @
om	? O m
onkel	? O N k @ l
ordenlich	? O r d @ n l I C
order	? O r d 6
ordnung	? O6 d n U N
ordum	? O r d U m
orentieren	? o r E n t i: r @ n
organizieren	? O r g a n i ts i: r @ n
orienalichen	? o: r i @ n a l I C @ n
orten	? O6 t @ n
paap	p a ? a p
pair	p aI 6
pakung	p a k U N
par	p a r
park	p a r k
parr	p a r
party	p a r t i
passen	p a s @ n
passendes	p a s @ n d @ s
passiet	p a s i: E t
peachwork	p e: a: x v 96 k a
perfum	p E6 f O6 U m
personen	p E6 z o: n @ n
personlich	p E6 z o m n l I C
personliche	p E6 z o m n l I C @
personlichen	p E6 z o m n l I C @ n
persöhnlich	p E6 z o ? 9 n l I C
persönameischen	p E6 z o 9 n a m aI S @ n
pipi	p i: p I
pittza	p I t t s a
plan	p l a: n
platz	p l a t s
platze	p l a t s @
plaze	p l a: ts @
popo	p o p o
possitive	p O s i t i: v @
potenziale	p o t E n ts j a: l @
practisieren	p r E k t i z i: r @ n
prakticher	p r a k t I C 6
praktikant	p r a k t i k a n t
praktikantenstelle	p r a k t i k a n t @ n S t E l @
praktikantin	p r a k t i k a n t I n
praktikum	p r a k t i k U m
praktikumsplatz	p r a k t i k U m s p l a t s
presäntieren	p r E z E n t i: r @ n
pro-jahr	p r o: j a: r
problem	p r o b l e: m
probleme	p r o b l e: m @
profiteren	p r o f i t @ r @ n
prufun	p r u: f u: n
prüfung	p r y: f U N
prüfungen	p r y: f U N @ n
punkte	p U N k t @
punktlich	p U N k t l I C
puntlich	p ? U n t l I C
qm	k u: ? E m
qm²	k u: ? E m
radfahren	r a: t f a: r @ n
rauf	r aU f
rauss	r aU s
realität	r e a l i t E: t
realizieren	r e a l i ts i: r @ n
rechancieren	r E k a n ts i: r @ n
rechtanwalt	r E C t a n v a l t
regelmessig	r e: g @ l m E s I C
reise	r aI z @
reisen	r aI z @ n
religios	r e l i g j o: s
rendiert	r E n d i: r t
respekt	r e s p E k t
restaurants	r E s t o r a: s
richtung	r I C t U N
rießig	r i: s I C
rihtige	r I t I g @
riserviren	r i: z 6 v i r @ n
ruf	r u: f
ruffe	r u: f @
ruhe	r u: @
ruoh	r u: o: x
rusch	r U S
rühig	r y: I C
sache	z a x @
sachen	z a x @ n
saiet	z aI @ t
samstag	z a m s t a: k
samt	z a m t
sasamen	z a z a: m @ n
schachtel	S a x t @ l
schal	S a: l
schampoo	S a: m p u
schance	S a n ts @
schen	S @ n
schiffsfahrt	S I f s f a: r t
schik	S I k
schiken	S I k @ n
schinken	S I N k @ n
schinkt	S I N k t
schlafe	S l a: f @
schlafezimmer	S l a: f @ ts I m 6
schlafzimmer	S l a: f ts I m 6
schlüssel	S l Y s @ l
schmecksache	S m E k z a x @
schneib	S n aI p
schokolade	S o k o l a: d @
schon	S o: n
schone	S o: n @
schones	S o: n @ s
schpaziren	S p a ts i r @ n
schpeter	S p e t 6
schreipt	S r aI p t
schreklich	S r @ k l I C
schrekliche	S r @ k l I C @
schriflich	S r I f l I C
schtifftsohn	S t I f t z o: n
schuche	S u: x @
schun	S U n
schwehr	S v e: r
schweiz	S v aI ts
schwerig	S v e r I C
schwester	S v E s t 6
schwimmanzug	S v I m a n ts u: k
schwimmbad	S v I m b a: t
schwimmbaden	S v I m b a: d @ n
schwimmen	S v I m @ n
schwimmenbad	S v I m @ n b a: t
schwimmkleidung	S v I m k l aI d U N
schwirigkeiten	S v i r I C k aI t @ n
schwmbad	S f m b a: t
schön	S 2: n
scwimen	S v i: m @ n
seain	z @ ? aI n
sebst	z e: p s t
seeliche	z e: l I C @
seh	z e:
sehn	z e: n
sehr	z e:6
seiben	z aI b @ n
selb-standig	z E l p S t a n d I C
selbe	z E l b @
selbst-aufgebaut	z E l p s t ? aU f g @ b aU t
selbstangig	z E l p s t a N I C
selbststandig	z E l p s t S t a n d I C
september	z E p t E m b 6
ser	z E6
server	s 96 v 6
shekin	S e: k ? I n
shenken	S E N k @ n
sher	S 6
shicke	S I k @
shon	s h O n
shteht	s t e: t
shön/nett	S 2: n n @ t
shöne	S 2: n @
sicken	z I k @ n
sie	z i:
sinvoll	z I n f O l
situation	z i t u a ts j o: n
sms	? E s ? E m ? E s
so	z O
sog	z o: k
soger	z O dZ 6
sohn	z o: n
sollter	z O l t 6
solt	z O l t
solte	z O l t @
sondan	z O n d a: n
sonder	z O n d 6
sonnst	z O n s t
sonntag	z O n t a: k
sontag	z O n t a: k
sorge	z O6 g @
sosammen	z o: z a m @ n
sovoll	z o v O l
sowol	z o v O l
spachliches	S p a: x l I C @ s
sparzieren	S p a r ts i: r @ n
spater	S p a: t 6
spatsseren	S p a t s z @ r @ n
spatzieren	S p a t s i: r @ n
spazern	S p a: ts 6 n
spazieregehen	S p a ts i: r e g e: @ n
spaziergehen	S p a ts i: E6 g e: @ n
spaß	S p a: s
speciall	S p E ts j a: l
speichkarte	S p aI C k a: r t @
speilt	S p aI l t
speziale	S p e ts j a: l @
sprache	S p r a: x @
sprachen	S p r a: x @ n
spraren	s p r a: r @ n
sprechende	S p r E C @ n d @
spresche	S p r E S @
späzieren	S p E: t s i: r @ n
sreiben	s r aI b @ n
stadt	S t a t
stadtmitte	S t a t m I t @
stamt	S t a m t
standansiert	S t a n d a: n z i: r t
stehts	S t e: t s
stele	S t e: l @
stelle	S t E l @
stellen	S t E l @ n
str	? E s t e: ? E r
stralende	S t r a: l E n d @
strand	S t r a n t
strasse	S t r a: s @
straße	S t r a: s @
stunde	S t U n d @
störren	S t 2: r @ n
stück	S t Y k
suhe	z u: @
susamen	z U z a: m @ n
suße	z u: s @
swimmen	s v I m @ n
süsse	z Y s @
tag	t a: k
tage	t a: g @
tagen	t a: g @ n
tags	t a: k s
tansen	t a n z @ n
tante	t a n t @
tatigkeit	t a t I C k aI t
tauch	t aU x
team	t i: m
teamarbeit	t @ ? a m ? a r b aI t
teamfähike	t @ ? a m f E: k @
techniche	t E C n I C @
teil	t aI l
teilzeit	t aI l ts aI t
telefonich	t e l e f O n I C
telefonniert	t e l e f o: n i: r t
telephon	t e l e f o: n
teoretische	t e o r e: t I S @
tereffen	t E r E f @ n
termin	t E6 m i: n
termine	t E6 m i: n @
teur	t OY r
teurste	t OY 6 s t @
text	t E k s t
theoretishe	t e o r @ t I s h @
ticket	t I k @ t
tielen	ts i: l @ n
tiere	t i: r @
tiket	t aI k t
tomate	t o m a: t @
tool	t u: l
tradition	t r a d i ts j o: n
traditionalle	t r a d i ts j o n a l @
trausen	t r aU z @ n
trefen	t r @ f @ n
treffung	t r E f U N
triko	t r i: k o
trinken	t r I N k @ n
trotztdem	t r o: t s t d e: m
trozdem	t r O ts d e: m
träumen	t r OY m @ n
trüba	t r y: b ? a
tu	t u:
tätigkeit	t E: t I C k aI t
u	? u:
u.s.w.	U s v
uber	? U b 6
uberliegt	? U b 6 l i: k t
uberzeug	? U b 6 ts OY k
uech	? Y C
uhr	? u:6
um	? U m
umgesiedilt	? U m g @ z i: d ? I l t
umgesogen	? U m g @ z o: g @ n
umlage	? U m l a: g @
umlagen	? U m l a: g @ n
ums	? U m s
umzehen	? U m ts e: @ n
un	? U n
unbedigt	? U n b @ d I C t
unbeding	? U n b @ d I N
unbedinkt	? U n b @ d I N k t
unbefridigend	? U n b @ f r i d I g @ n t
und	? U n t
unde	? U n d @
unfangreiche	? U n f a N g r aI C @
ung	U N
ungariche	? U N g a: r I C @
ungebung	? U n g e: b U N
ungefahr	? U n g @ f a: r
ungefähe	? U n g @ f E k
ungefär	? U n g @ f 6
ungewohnlich	? U n g @ v o: n l I C
ungäfehr	? U n g E: f e: r
universität	? u n i v E6 z i t E: t
unnötzlich	? U n n 9 t s l I C
uns	? U n s
unsimphatisch	? U n z I m f a t I S
unsympatisch	? U n z Y m p a t I S
unterhaltung	? U n t 6 h a l t U N
unternemmen	? U n t 6 n E m @ n
unterschieden	? U n t 6 S i: d @ n
unterschietliche	? U n t 6 S j E t l I C @
unvergäsliche	? U n v E6 k @ E s l I C @
unvermeindlich	? U n v E6 m 2: aI n t l I C
unz	? U n ts
unzwar	? U n ts v a r
urlaub	? u:6 l aU p
urlob	? U r l o: p
usere	j u: @ r @
useren	j u: @ r @ n
vahren	v a: r @ n
varaus	v a: r aU s
vater	f a: t 6
vegen	v e: g @ n
velleicht	f E l aI C t
venig	v e: n I C
venniger	v E n I g 6
verantwortung	f E6 ? a n t v O6 t U N
verbandten	f E6 b a n t s t @ n
verbesern	f E6 b @ l z 6 n
verbessen	f E6 b @ l s @ n
verbesseren	f E6 b @ l s @ r @ n
verbliebe	f E6 p b l i: b @
verdine	f 6 d i: n @
verdinnen	f 6 d I n @ n
vereiban	f @ r aI b a: n
vereihatet	f @ b aI h a: t @ t
verfugung	f E6 f a: u: g U N
verfügung	f E6 f y: g U N
vergesen	f 6 g e: z @ n
verheirated	f E6 h O aI r a t @ t
verkehrsgunstige	f E6 k @ h O6 s g U n s t I g @
verkehrsmittel	f E6 k e:6 s m I t @ l
verlauft	f E6 l U aU f t
verlaüft	f E6 l U aU Y f t
vermeiten	f E6 m 2: aI t @ n
vermese	f E6 m 2: @ z @
vermiter	f E6 m 2: i: t 6
vermitllen	f E6 m 2: I t l @ n
vermitten	f E6 m 2: I t @ n
verneinbaren	f E6 n j ? aI n b a: r @ n
verschidene	f E6 z I C i d @ n @
versiecherte	f E6 z o i: C 6 t @
versiedene	f E6 z o i: d @ n @
versprechend	f E6 S p r E C @ n t
vertig	v E6 t aU I C
vertrag	f E6 t r a: k
vertrieb	f E6 t r i: p
vertriebspraktikantenstelle	f E6 t r a: i: p s p r a k t i k a n t @ n S t E l @
verwandet	f 6 v a n d @ t
verwandten	f E6 v a n t @ n
verziechten	f 6 ts i: C t @ n
vesuchen	v b e: u: x @ n
veter	f e: t 6
vezichten	v e: ts I C t @ n
vie	f i:
viel	f i: l
vielGruß	f i: l g r u: s
viele	f i: l @
vieleich	f i: l aI C
vieleicht	f i: l aI C t
vielfälltige	f i: l f E l l t I g @
vielle	f i: l @
vielleich	f i l aI C
vielleicht	f i l aI C t
viellen	f i: l @ n
viertel	f I6 t @ l
vietnamesich	v j E t n a m @ z I C
vietnamesiche	v j E t n a m @ z I C @
vile	f aI l @
vilechte	v aI l E C t @
villeicht	f i: l aI C t
volgenden	f O l g @ n d @ n
voll	f O l
vollgendes	f O l g @ n d @ s
vollte	f O l t @
vondreitag	v O n d r aI t a: k
vor	f o:6
voraus	f o: r aU s
vorberaitet	f o:6 r b 6 ? aI t @ t
vorbereitat	f o:6 r b @ r aI t a: t
vorgestelte	f o:6 r g @ S t @ l t @
vorschlag	f o:6 S l a: k
vorschriften	f o:6 S r I f t @ n
vorstelen	f o:6 S t E l @ n
vorstellungsspräch	f o:6 S t E l U N s S p r E: C
vorteile	f o:6 t aI l @
vortiele	f o:6 r ts i: l @
vortsetzen	f o:6 r t s E t s @ n
vortzusetzen	f o:6 r t s u z E t s @ n
vorurteilung	f o r t r t aI l U N
vrondichen	v ? I O n d I C @ n
wahr	v a: r
wan	v a: n
wann	v a n
warmherzigkeit	v a r m h 6 ts I C k aI t
warmmiete	v a r m m i: t @
warn	v a r n
was	v a s
wasser	v a s 6
wecseln	v E k z @ l n
wegen	v e: g @ n
weider	v aI d 6
weil	v aI l
weill	v aI l
weis	v aI s
weise	v aI z @
weiss	v aI s
weisst	v aI s t
weist	v aI s t
weitermacher	v aI t 6 m a x 6
weitweg	v aI t v e: k
weißst	v aI s s t
wel	v E l
welhe	v E l h E
welkomme	v E l k O m @
welsche	v E l S @
welschen	v E l S @ n
wen	v e: n
wenn	v E n
werder	v @ r d 6
were	v e: r @
west	v E s t
wharscheinlich	f a r S aI n l I C
whonung	f o: n U N
wi	v I
wichtich	v I C t I C
wichtichste	v I C t I C s t @
wider	v i: d 6
wie	v i:
wiede	v i: d @
wiehast	v i: h a s t
wier	v i: @
wiessen	v i: s @ n
wiest	v i: s t
wigetes	v I g @ t @ s
wigets	v I g @ t s
wigt	v I k t
wil	v i: l
will	v I l
willst	v I l s t
wilst	v I l s t
wir	v i:6
wird	v I6 t
wisen	v i: z @ n
wisky	v I s k i
witchtig	v I t C t I C
wo	v o:
woch	v O x
woche	v O x @
wochen	v O x @ n
wochende	v O x @ n d @
wochenend	v O x @ n ? E n t
wochenenda	v O x @ n ? E n d a
wochenendausflug	v O x @ n ? E n t aU s f l u: k
wochenende	v O x @ n ? E n d @
wochne	v O x n @
wochnende	v O x n E n d @
wochnenden	v O x n E n d @ n
wochnung	v O x n U N
wohen	v o h e: n
wohlwellende	v o: l v E l @ n d @
wohnblock	v o: n b l O k
wohngemeinschaf	v o: n g @ m aI n S a: f
wohnort	v o: n ? O6 t
wohnug	v o: n u: k
wohnung	v o: n U N
wohnungen	v o: n U N @ n
wohnunger	v o: n U N 6
wohnungmit	v o: n U N m I t
wohnungsbüro	v o: n U N s b y r o:
wohnungssuche	v o: n U N s z u: x @
wohnvertrag	v o: n v 6 t r a: k
wohnzimmer	v o: n ts I m 6
wohung	v o h U N
wolen	v o: l @ n
woll	v O l
wollt	v O l t
wolte	v O l t @
wonderbae	v O n d 6 b a e:
wonderbar	v O n d 6 b a: r
wonnen	v O n @ n
worlesen	v 96 l U @ z @ n
wort	v O6 t
worte	v O6 t @
wunderschon	v U n d 6 S o: n
wunderware	v U n d 6 v a: r @
wunsch	v U n S
wunsche	v U n S @
währe	v E: r @
wäsche	v E S @
wöhnen	v 2: n @ n
wünche	v Y N @
wünchen	v Y N @ n
wünderbaren	v Y n d 6 b a: r @ n
wünsch	v Y n S
wünsche	v Y n S @
würtzen	v y: r t t s @ n
wüsche	v Y S @
z.b.	ts E t b e:
zammel	ts a m @ l
zehe	ts e: @
zeher	ts e: ? i: r
zeihen	ts aI @ n
zeilstrebige	ts aI l S t r e b I g @
zeit	ts aI t
zeitschrift	t s aI t S r I f t
zentrum	ts E n t r U m
zhan	ts h a n
ziehen	ts i: @ n
ziehn	ts i: n
ziel	ts i: l
ziew	ts j j u:
zimm	ts I m
zimmer	ts I m 6
zu	ts u
zuFahren	ts u: f a: r @ n
zuchause	ts U k aU z @
zuferlesig	ts u: f 6 l e: z I C
zufinden	ts u f I n d @ n
zug	ts u: k
zuhaben	ts u: h a: b @ n
zuhause	ts u h aU z @
zukunftigen	t s u: k U n f t I g @ n
zukunftiger	t s u: k U n f t I g 6
zuküntige	ts u k Y n t I g @
zuleserinnen	ts u l @ z @ r I n @ n
zum	ts U m
zupassen	ts u p a s @ n
zurich	ts u r I C
zuruck	ts u r U k
zuruk	ts u r U k
zurücke	ts u r Y k @
zusamen	ts u: z a: m @ n
zusammen	ts u z a m @ n
zusammenfeiern	ts u z a m @ n f aI 6 n
zusammengestzt	ts u z a m @ n g @ t s t s t
zusemmen	ts u z E m @ n
zussamen	ts u s z a m @ n
zussammen	ts u s z a m @ n
zuverfassen	ts u v E6 f a: r s @ n
zuverfügung	ts u v 6 f y: g U N
zuverkaufen	ts u: f E6 k aU f @ n
zuverlessig	ts u f E6 l U ? E s I C
zuverläsige	ts u f E6 l U E: z I g @
zuverstehen	ts u v 6 S t e: @ n
zuzamen	ts u: ts a: m @ n
zuzammen	ts u: ts a m @ n
zuzeit	ts u ts aI t
zwei	ts v aI
zweizimmer	ts v aI t s I m 6
zwilingers	ts v i l I N 6 s
zß	ts E t S a6 f @ s ? E s
züge	ts y: g @
zügern	ts y: g 6 n
zürck	ts y: r k
zürick	ts y: r I k
züruck	ts y: r U k
zürück	ts y: r Y k
zürük	ts y: r Y k
²	
África	? a f r i k a
Älter	? E l t 6
Öesterreich	? 2: s t 6 r aI C
Öffentlideverkehrsmittels	? 9 f @ n t l i d @ f 6 k e: 6 s m I t @ l s
Überlegen	? y: b 6 l e: g @ n
Übrigen	? y: b r I g @ n
änderung	? E n d @ r U N
öffensichtlich	? 9 f @ n z I C t l I C
überhauptnicht	? y: b 6 h aU p t n I C t
überlegung	? y: b 6 l e: g U N
übernahme	? y: b 6 n a: m @
überstunden	? y: b 6 S t U n d @ n
